A, B, feasible, reason, parameters, extractedLOC, reductionCC, extractedMethodCC, accumulatedInherentComponent, accumulatedNestingComponent, numberNestingContributors, nesting
23921, 23994, 0, "Selected statements contain a return statement but not all possible execution flows end in a return. Semantics may not be preserved if you proceed.", 0, 0, 3, 2, 2, 0, 1, 1
24041, 24114, 0, "Selected statements contain a return statement but not all possible execution flows end in a return. Semantics may not be preserved if you proceed.", 0, 0, 3, 2, 2, 0, 1, 1
24161, 24234, 0, "Selected statements contain a return statement but not all possible execution flows end in a return. Semantics may not be preserved if you proceed.", 0, 0, 3, 2, 2, 0, 1, 1
24345, 24418, 0, "Selected statements contain a return statement but not all possible execution flows end in a return. Semantics may not be preserved if you proceed.", 0, 0, 3, 2, 2, 0, 1, 1
24638, 24711, 0, "Selected statements contain a return statement but not all possible execution flows end in a return. Semantics may not be preserved if you proceed.", 0, 0, 3, 2, 2, 0, 1, 1
24131, 24290, 0, "Selected statements contain a return statement but not all possible execution flows end in a return. Semantics may not be preserved if you proceed.", 0, 0, 5, 5, 4, 1, 1, 0
23891, 24876, 0, "Selected statements contain a return statement but not all possible execution flows end in a return. Semantics may not be preserved if you proceed.", 0, 0, 31, 31, 24, 7, 7, 0
24302, 24583, 0, "Selected statements contain a return statement but not all possible execution flows end in a return. Semantics may not be preserved if you proceed.", 0, 0, 9, 9, 7, 2, 2, 0
24011, 24290, 0, "Selected statements contain a return statement but not all possible execution flows end in a return. Semantics may not be preserved if you proceed.", 0, 0, 9, 9, 7, 2, 2, 0
24758, 24820, 0, "Selected statements contain a return statement but not all possible execution flows end in a return. Semantics may not be preserved if you proceed.", 0, 0, 2, 1, 1, 0, 1, 1
24302, 24876, 0, "Selected statements contain a return statement but not all possible execution flows end in a return. Semantics may not be preserved if you proceed.", 0, 0, 18, 18, 14, 4, 4, 0
24465, 24527, 0, "Selected statements contain a return statement but not all possible execution flows end in a return. Semantics may not be preserved if you proceed.", 0, 0, 2, 1, 1, 0, 1, 1
24595, 24876, 0, "Selected statements contain a return statement but not all possible execution flows end in a return. Semantics may not be preserved if you proceed.", 0, 0, 9, 9, 7, 2, 2, 0
23891, 24900, 1, "OK", 6, 41, 31, 31, 24, 7, 7, 0
24728, 24876, 0, "Selected statements contain a return statement but not all possible execution flows end in a return. Semantics may not be preserved if you proceed.", 0, 0, 4, 4, 3, 1, 1, 0
23891, 24290, 0, "Selected statements contain a return statement but not all possible execution flows end in a return. Semantics may not be preserved if you proceed.", 0, 0, 13, 13, 10, 3, 3, 0
24302, 24900, 1, "OK", 4, 25, 18, 18, 14, 4, 4, 0
23891, 24583, 0, "Selected statements contain a return statement but not all possible execution flows end in a return. Semantics may not be preserved if you proceed.", 0, 0, 22, 22, 17, 5, 5, 0
24595, 24900, 1, "OK", 2, 13, 9, 9, 7, 2, 2, 0
24435, 24583, 0, "Selected statements contain a return statement but not all possible execution flows end in a return. Semantics may not be preserved if you proceed.", 0, 0, 4, 4, 3, 1, 1, 0