A, B, feasible, reason, parameters, extractedLOC, reductionCC, extractedMethodCC, accumulatedInherentComponent, accumulatedNestingComponent, numberNestingContributors, nesting
18388, 18717, 0, "Ambiguous return value: Selected block modifies more than one local variable used in subsequent code. Affected variables are:  int pad int sepCnt int len", 0, 0, 6, 6, 4, 2, 2, 0
18581, 19905, 1, "OK", 6, 35, 12, 12, 8, 4, 4, 0
18262, 18787, 0, "Ambiguous return value: Selected block modifies more than one local variable used in subsequent code. Affected variables are:  int eIx int pad int sepCnt int len byte[] bytes", 0, 0, 8, 8, 6, 2, 2, 0
18906, 19930, 1, "OK", 8, 30, 9, 9, 6, 3, 3, 0
18674, 19569, 0, "Ambiguous return value: Selected block modifies more than one local variable used in subsequent code. Affected variables are:  int sIx int len byte[] bytes int d", 0, 0, 4, 4, 3, 1, 1, 0
18144, 18210, 1, "OK", 3, 2, 2, 2, 2, 0, 0, 0
18144, 18468, 0, "Ambiguous return value: Selected block modifies more than one local variable used in subsequent code. Affected variables are:  int sIx int eIx int pad", 0, 0, 7, 7, 6, 1, 1, 0
18262, 19930, 1, "OK", 4, 43, 17, 17, 12, 5, 5, 0
18262, 18524, 0, "Ambiguous return value: Selected block modifies more than one local variable used in subsequent code. Affected variables are:  int eIx int pad int cCnt", 0, 0, 5, 5, 4, 1, 1, 0
17929, 19905, 0, "Selected statements contain a return statement but not all possible execution flows end in a return. Semantics may not be preserved if you proceed.", 0, 0, 20, 20, 15, 5, 5, 0
18906, 19569, 0, "Ambiguous return value: Selected block modifies more than one local variable used in subsequent code. Affected variables are:  int sIx int d", 0, 0, 4, 4, 3, 1, 1, 0
19373, 19558, 0, "Ambiguous return value: Selected block modifies more than one local variable used in subsequent code. Affected variables are:  int sIx int d int cc", 0, 0, 3, 2, 2, 0, 1, 1
18262, 19569, 0, "Ambiguous return value: Selected block modifies more than one local variable used in subsequent code. Affected variables are:  int sIx int eIx int pad int len byte[] bytes int d", 0, 0, 12, 12, 9, 3, 3, 0
18581, 18896, 0, "Ambiguous return value: Selected block modifies more than one local variable used in subsequent code. Affected variables are:  int sepCnt int len byte[] bytes int d", 0, 0, 3, 3, 2, 1, 1, 0
18499, 19905, 1, "OK", 5, 36, 12, 12, 8, 4, 4, 0
19286, 19558, 0, "Ambiguous return value: Selected block modifies more than one local variable used in subsequent code. Affected variables are:  int sIx int d int cc", 0, 0, 3, 2, 2, 0, 1, 1
18262, 18662, 0, "Ambiguous return value: Selected block modifies more than one local variable used in subsequent code. Affected variables are:  int eIx int pad int cCnt int sepCnt", 0, 0, 8, 8, 6, 2, 2, 0
18388, 18468, 1, "OK", 2, 1, 3, 3, 2, 1, 1, 0
18758, 19930, 1, "OK", 6, 34, 9, 9, 6, 3, 3, 0
18886, 19930, 1, "OK", 7, 31, 9, 9, 6, 3, 3, 0
17929, 18896, 0, "Selected statements contain a return statement but not all possible execution flows end in a return. Semantics may not be preserved if you proceed.", 0, 0, 11, 11, 9, 2, 2, 0
18005, 18717, 0, "Ambiguous return value: Selected block modifies more than one local variable used in subsequent code. Affected variables are:  int sIx int eIx int pad int sepCnt int len", 0, 0, 10, 10, 8, 2, 2, 0
18758, 19569, 0, "Ambiguous return value: Selected block modifies more than one local variable used in subsequent code. Affected variables are:  int sIx byte[] bytes int d", 0, 0, 4, 4, 3, 1, 1, 0
18886, 19569, 0, "Ambiguous return value: Selected block modifies more than one local variable used in subsequent code. Affected variables are:  int sIx int d", 0, 0, 4, 4, 3, 1, 1, 0
18005, 18210, 0, "Ambiguous return value: Selected block modifies more than one local variable used in subsequent code. Affected variables are:  int sIx int eIx", 0, 0, 2, 2, 2, 0, 0, 0
18581, 18787, 0, "Ambiguous return value: Selected block modifies more than one local variable used in subsequent code. Affected variables are:  int sepCnt int len byte[] bytes", 0, 0, 3, 3, 2, 1, 1, 0
18388, 19905, 1, "OK", 4, 37, 15, 15, 10, 5, 5, 0
18499, 18896, 0, "Ambiguous return value: Selected block modifies more than one local variable used in subsequent code. Affected variables are:  int sepCnt int len byte[] bytes int d", 0, 0, 3, 3, 2, 1, 1, 0
17929, 17993, 0, "Selected statements contain a return statement but not all possible execution flows end in a return. Semantics may not be preserved if you proceed.", 0, 0, 1, 1, 1, 0, 0, 0
18005, 18326, 0, "Ambiguous return value: Selected block modifies more than one local variable used in subsequent code. Affected variables are:  int sIx int eIx", 0, 0, 4, 4, 4, 0, 0, 0
18144, 19905, 1, "OK", 4, 45, 19, 19, 14, 5, 5, 0
19460, 19558, 0, "Ambiguous return value: Selected block modifies more than one local variable used in subsequent code. Affected variables are:  int sIx int cc", 0, 0, 3, 2, 2, 0, 1, 1
19581, 19905, 1, "OK", 7, 9, 5, 5, 3, 2, 2, 0
18581, 19930, 1, "OK", 6, 37, 12, 12, 8, 4, 4, 0
19697, 19894, 1, "OK", 8, 5, 4, 2, 2, 0, 2, 1
18499, 19930, 1, "OK", 5, 38, 12, 12, 8, 4, 4, 0
17929, 18787, 0, "Selected statements contain a return statement but not all possible execution flows end in a return. Semantics may not be preserved if you proceed.", 0, 0, 11, 11, 9, 2, 2, 0
18144, 19930, 1, "OK", 4, 47, 19, 19, 14, 5, 5, 0
18388, 18896, 0, "Ambiguous return value: Selected block modifies more than one local variable used in subsequent code. Affected variables are:  int pad int sepCnt int len byte[] bytes int d", 0, 0, 6, 6, 4, 2, 2, 0
18581, 19569, 0, "Ambiguous return value: Selected block modifies more than one local variable used in subsequent code. Affected variables are:  int sIx int len byte[] bytes int d", 0, 0, 7, 7, 5, 2, 2, 0
18144, 18524, 0, "Ambiguous return value: Selected block modifies more than one local variable used in subsequent code. Affected variables are:  int sIx int eIx int pad int cCnt", 0, 0, 7, 7, 6, 1, 1, 0
17929, 18662, 0, "Selected statements contain a return statement but not all possible execution flows end in a return. Semantics may not be preserved if you proceed.", 0, 0, 11, 11, 9, 2, 2, 0
19581, 19930, 1, "OK", 7, 11, 5, 5, 3, 2, 2, 0
19673, 19894, 1, "OK", 7, 6, 4, 2, 2, 0, 2, 1
18005, 18468, 0, "Ambiguous return value: Selected block modifies more than one local variable used in subsequent code. Affected variables are:  int sIx int eIx int pad", 0, 0, 7, 7, 6, 1, 1, 0
18144, 18896, 0, "Ambiguous return value: Selected block modifies more than one local variable used in subsequent code. Affected variables are:  int sIx int eIx int pad int sepCnt int len byte[] bytes int d", 0, 0, 10, 10, 8, 2, 2, 0
17929, 19930, 1, "OK", 3, 54, 20, 20, 15, 5, 5, 0
18581, 18662, 1, "OK", 3, 1, 3, 3, 2, 1, 1, 0
17929, 18524, 0, "Selected statements contain a return statement but not all possible execution flows end in a return. Semantics may not be preserved if you proceed.", 0, 0, 8, 8, 7, 1, 1, 0
18262, 18717, 0, "Ambiguous return value: Selected block modifies more than one local variable used in subsequent code. Affected variables are:  int eIx int pad int sepCnt int len", 0, 0, 8, 8, 6, 2, 2, 0
17929, 19569, 0, "Selected statements contain a return statement but not all possible execution flows end in a return. Semantics may not be preserved if you proceed.", 0, 0, 15, 15, 12, 3, 3, 0
18388, 18524, 0, "Ambiguous return value: Selected block modifies more than one local variable used in subsequent code. Affected variables are:  int pad int cCnt", 0, 0, 3, 3, 2, 1, 1, 0
18005, 19905, 1, "OK", 3, 48, 19, 19, 14, 5, 5, 0
18499, 19569, 0, "Ambiguous return value: Selected block modifies more than one local variable used in subsequent code. Affected variables are:  int sIx int len byte[] bytes int d", 0, 0, 7, 7, 5, 2, 2, 0
18262, 18468, 0, "Ambiguous return value: Selected block modifies more than one local variable used in subsequent code. Affected variables are:  int eIx int pad", 0, 0, 5, 5, 4, 1, 1, 0
18499, 18787, 0, "Ambiguous return value: Selected block modifies more than one local variable used in subsequent code. Affected variables are:  int sepCnt int len byte[] bytes", 0, 0, 3, 3, 2, 1, 1, 0
18262, 18326, 1, "OK", 2, 2, 2, 2, 2, 0, 0, 0
18144, 18787, 0, "Ambiguous return value: Selected block modifies more than one local variable used in subsequent code. Affected variables are:  int sIx int eIx int pad int sepCnt int len byte[] bytes", 0, 0, 10, 10, 8, 2, 2, 0
18499, 18662, 0, "Ambiguous return value: Selected block modifies more than one local variable used in subsequent code. Affected variables are:  int cCnt int sepCnt", 0, 0, 3, 3, 2, 1, 1, 0
18388, 19930, 1, "OK", 4, 39, 15, 15, 10, 5, 5, 0
18144, 18662, 0, "Ambiguous return value: Selected block modifies more than one local variable used in subsequent code. Affected variables are:  int sIx int eIx int pad int cCnt int sepCnt", 0, 0, 10, 10, 8, 2, 2, 0
19697, 19798, 1, "OK", 5, 2, 2, 1, 1, 0, 1, 1
17929, 18051, 0, "Selected statements contain a return statement but not all possible execution flows end in a return. Semantics may not be preserved if you proceed.", 0, 0, 1, 1, 1, 0, 0, 0
18005, 18896, 0, "Ambiguous return value: Selected block modifies more than one local variable used in subsequent code. Affected variables are:  int sIx int eIx int pad int sepCnt int len byte[] bytes int d", 0, 0, 10, 10, 8, 2, 2, 0
18388, 19569, 0, "Ambiguous return value: Selected block modifies more than one local variable used in subsequent code. Affected variables are:  int sIx int pad int len byte[] bytes int d", 0, 0, 10, 10, 7, 3, 3, 0
19673, 19798, 1, "OK", 4, 3, 2, 1, 1, 0, 1, 1
18388, 18787, 0, "Ambiguous return value: Selected block modifies more than one local variable used in subsequent code. Affected variables are:  int pad int sepCnt int len byte[] bytes", 0, 0, 6, 6, 4, 2, 2, 0
19814, 19894, 1, "OK", 4, 2, 2, 1, 1, 0, 1, 1
18674, 19905, 1, "OK", 6, 33, 9, 9, 6, 3, 3, 0
18144, 19569, 0, "Ambiguous return value: Selected block modifies more than one local variable used in subsequent code. Affected variables are:  int sIx int eIx int pad int len byte[] bytes int d", 0, 0, 14, 14, 11, 3, 3, 0
18388, 18662, 0, "Ambiguous return value: Selected block modifies more than one local variable used in subsequent code. Affected variables are:  int pad int cCnt int sepCnt", 0, 0, 6, 6, 4, 2, 2, 0
18005, 18524, 0, "Ambiguous return value: Selected block modifies more than one local variable used in subsequent code. Affected variables are:  int sIx int eIx int pad int cCnt", 0, 0, 7, 7, 6, 1, 1, 0
18581, 18717, 0, "Ambiguous return value: Selected block modifies more than one local variable used in subsequent code. Affected variables are:  int sepCnt int len", 0, 0, 3, 3, 2, 1, 1, 0
18674, 19930, 1, "OK", 6, 35, 9, 9, 6, 3, 3, 0
18906, 19905, 1, "OK", 8, 28, 9, 9, 6, 3, 3, 0
18262, 19905, 1, "OK", 4, 41, 17, 17, 12, 5, 5, 0
17929, 18326, 0, "Selected statements contain a return statement but not all possible execution flows end in a return. Semantics may not be preserved if you proceed.", 0, 0, 5, 5, 5, 0, 0, 0
18005, 18787, 0, "Ambiguous return value: Selected block modifies more than one local variable used in subsequent code. Affected variables are:  int sIx int eIx int pad int sepCnt int len byte[] bytes", 0, 0, 10, 10, 8, 2, 2, 0
19330, 19558, 0, "Ambiguous return value: Selected block modifies more than one local variable used in subsequent code. Affected variables are:  int sIx int d int cc", 0, 0, 3, 2, 2, 0, 1, 1
18005, 19930, 1, "OK", 3, 50, 19, 19, 14, 5, 5, 0
17929, 18210, 0, "Selected statements contain a return statement but not all possible execution flows end in a return. Semantics may not be preserved if you proceed.", 0, 0, 3, 3, 3, 0, 0, 0
18499, 18717, 0, "Ambiguous return value: Selected block modifies more than one local variable used in subsequent code. Affected variables are:  int sepCnt int len", 0, 0, 3, 3, 2, 1, 1, 0
18262, 18896, 0, "Ambiguous return value: Selected block modifies more than one local variable used in subsequent code. Affected variables are:  int eIx int pad int sepCnt int len byte[] bytes int d", 0, 0, 8, 8, 6, 2, 2, 0
17929, 18468, 0, "Selected statements contain a return statement but not all possible execution flows end in a return. Semantics may not be preserved if you proceed.", 0, 0, 8, 8, 7, 1, 1, 0
19050, 19558, 0, "Ambiguous return value: Selected block modifies more than one local variable used in subsequent code. Affected variables are:  int sIx int d int cc", 0, 0, 3, 2, 2, 0, 1, 1
18005, 19569, 0, "Ambiguous return value: Selected block modifies more than one local variable used in subsequent code. Affected variables are:  int sIx int eIx int pad int len byte[] bytes int d", 0, 0, 14, 14, 11, 3, 3, 0
18758, 19905, 1, "OK", 6, 32, 9, 9, 6, 3, 3, 0
18886, 19905, 1, "OK", 7, 29, 9, 9, 6, 3, 3, 0
18144, 18717, 0, "Ambiguous return value: Selected block modifies more than one local variable used in subsequent code. Affected variables are:  int sIx int eIx int pad int sepCnt int len", 0, 0, 10, 10, 8, 2, 2, 0
18005, 18662, 0, "Ambiguous return value: Selected block modifies more than one local variable used in subsequent code. Affected variables are:  int sIx int eIx int pad int cCnt int sepCnt", 0, 0, 10, 10, 8, 2, 2, 0
17929, 18717, 0, "Selected statements contain a return statement but not all possible execution flows end in a return. Semantics may not be preserved if you proceed.", 0, 0, 11, 11, 9, 2, 2, 0
18144, 18326, 0, "Ambiguous return value: Selected block modifies more than one local variable used in subsequent code. Affected variables are:  int sIx int eIx", 0, 0, 4, 4, 4, 0, 0, 0