A, B, feasible, reason, parameters, extractedLOC, reductionCC, extractedMethodCC, accumulatedInherentComponent, accumulatedNestingComponent, numberNestingContributors, nesting
34618, 35022, 0, "Selected statements contain a return statement but not all possible execution flows end in a return. Semantics may not be preserved if you proceed.", 0, 0, 4, 4, 3, 1, 1, 0
33561, 35022, 0, "Selected statements contain a return statement but not all possible execution flows end in a return. Semantics may not be preserved if you proceed.", 0, 0, 19, 19, 14, 5, 5, 0
34524, 34609, 0, "Selected statements contain a return statement but not all possible execution flows end in a return. Semantics may not be preserved if you proceed.", 0, 0, 3, 3, 2, 1, 1, 0
33626, 33904, 0, "Selected statements contain a return statement but not all possible execution flows end in a return. Semantics may not be preserved if you proceed.", 0, 0, 3, 3, 3, 0, 0, 0
33561, 33616, 0, "Selected statements contain a return statement but not all possible execution flows end in a return. Semantics may not be preserved if you proceed.", 0, 0, 1, 1, 1, 0, 0, 0
33816, 33904, 0, "Selected statements contain a return statement but not all possible execution flows end in a return. Semantics may not be preserved if you proceed.", 0, 0, 1, 1, 1, 0, 0, 0
33561, 34514, 0, "Selected statements contain a return statement but not all possible execution flows end in a return. Semantics may not be preserved if you proceed.", 0, 0, 12, 12, 9, 3, 3, 0
33914, 35096, 1, "OK", 1, 33, 15, 15, 10, 5, 5, 0
33713, 34514, 0, "Selected statements contain a return statement but not all possible execution flows end in a return. Semantics may not be preserved if you proceed.", 0, 0, 10, 10, 7, 3, 3, 0
33957, 34504, 1, "OK", 1, 15, 7, 4, 4, 0, 3, 1
34180, 34504, 1, "OK", 1, 9, 4, 2, 2, 0, 2, 1
34001, 34167, 0, "Selected statements contain a return statement but not all possible execution flows end in a return. Semantics may not be preserved if you proceed.", 0, 0, 3, 2, 2, 0, 1, 1
34293, 34459, 1, "OK", 1, 4, 2, 1, 1, 0, 1, 1
34524, 35022, 0, "Selected statements contain a return statement but not all possible execution flows end in a return. Semantics may not be preserved if you proceed.", 0, 0, 7, 7, 5, 2, 2, 0
33957, 34167, 0, "Selected statements contain a return statement but not all possible execution flows end in a return. Semantics may not be preserved if you proceed.", 0, 0, 3, 2, 2, 0, 1, 1
34293, 34504, 1, "OK", 1, 5, 2, 1, 1, 0, 1, 1
33626, 33806, 0, "Selected statements contain a return statement but not all possible execution flows end in a return. Semantics may not be preserved if you proceed.", 0, 0, 2, 2, 2, 0, 0, 0
33561, 33904, 0, "Selected statements contain a return statement but not all possible execution flows end in a return. Semantics may not be preserved if you proceed.", 0, 0, 4, 4, 4, 0, 0, 0
33914, 34609, 0, "Selected statements contain a return statement but not all possible execution flows end in a return. Semantics may not be preserved if you proceed.", 0, 0, 11, 11, 7, 4, 4, 0
33713, 33806, 0, "Selected statements contain a return statement but not all possible execution flows end in a return. Semantics may not be preserved if you proceed.", 0, 0, 1, 1, 1, 0, 0, 0
33626, 35096, 1, "OK", 1, 45, 18, 18, 13, 5, 5, 0
33713, 33904, 0, "Selected statements contain a return statement but not all possible execution flows end in a return. Semantics may not be preserved if you proceed.", 0, 0, 2, 2, 2, 0, 0, 0
34693, 35012, 0, "Selected statements contain a return statement but not all possible execution flows end in a return. Semantics may not be preserved if you proceed.", 0, 0, 3, 2, 2, 0, 1, 1
34375, 34504, 1, "OK", 2, 4, 2, 1, 1, 0, 1, 1
33957, 34279, 0, "Selected statements contain a return statement but not all possible execution flows end in a return. Semantics may not be preserved if you proceed.", 0, 0, 5, 3, 3, 0, 2, 1
34180, 34279, 1, "OK", 1, 3, 2, 1, 1, 0, 1, 1
34001, 34459, 0, "Selected statements contain a return statement but not all possible execution flows end in a return. Semantics may not be preserved if you proceed.", 0, 0, 7, 4, 4, 0, 3, 1
33914, 35022, 0, "Selected statements contain a return statement but not all possible execution flows end in a return. Semantics may not be preserved if you proceed.", 0, 0, 15, 15, 10, 5, 5, 0
33561, 33806, 0, "Selected statements contain a return statement but not all possible execution flows end in a return. Semantics may not be preserved if you proceed.", 0, 0, 3, 3, 3, 0, 0, 0
33957, 34459, 0, "Selected statements contain a return statement but not all possible execution flows end in a return. Semantics may not be preserved if you proceed.", 0, 0, 7, 4, 4, 0, 3, 1
33626, 34609, 0, "Selected statements contain a return statement but not all possible execution flows end in a return. Semantics may not be preserved if you proceed.", 0, 0, 14, 14, 10, 4, 4, 0
34001, 34504, 1, "OK", 1, 14, 7, 4, 4, 0, 3, 1
34180, 34459, 1, "OK", 1, 8, 4, 2, 2, 0, 2, 1
33914, 34514, 0, "Selected statements contain a return statement but not all possible execution flows end in a return. Semantics may not be preserved if you proceed.", 0, 0, 8, 8, 5, 3, 3, 0
33816, 34609, 0, "Selected statements contain a return statement but not all possible execution flows end in a return. Semantics may not be preserved if you proceed.", 0, 0, 12, 12, 8, 4, 4, 0
34618, 35096, 1, "OK", 1, 12, 4, 4, 3, 1, 1, 0
33816, 35096, 1, "OK", 1, 37, 16, 16, 11, 5, 5, 0
33713, 35096, 1, "OK", 1, 41, 17, 17, 12, 5, 5, 0
34001, 34362, 0, "Selected statements contain a return statement but not all possible execution flows end in a return. Semantics may not be preserved if you proceed.", 0, 0, 5, 3, 3, 0, 2, 1
33626, 33703, 0, "Selected statements contain a return statement but not all possible execution flows end in a return. Semantics may not be preserved if you proceed.", 0, 0, 1, 1, 1, 0, 0, 0
33626, 35022, 0, "Selected statements contain a return statement but not all possible execution flows end in a return. Semantics may not be preserved if you proceed.", 0, 0, 18, 18, 13, 5, 5, 0
34375, 34459, 1, "OK", 2, 3, 2, 1, 1, 0, 1, 1
33957, 34362, 0, "Selected statements contain a return statement but not all possible execution flows end in a return. Semantics may not be preserved if you proceed.", 0, 0, 5, 3, 3, 0, 2, 1
33816, 35022, 0, "Selected statements contain a return statement but not all possible execution flows end in a return. Semantics may not be preserved if you proceed.", 0, 0, 16, 16, 11, 5, 5, 0
34001, 34279, 0, "Selected statements contain a return statement but not all possible execution flows end in a return. Semantics may not be preserved if you proceed.", 0, 0, 5, 3, 3, 0, 2, 1
34180, 34362, 0, "Ambiguous return value: Selected block modifies more than one local variable used in subsequent code. Affected variables are:  String strVal Matcher matcher", 0, 0, 2, 1, 1, 0, 1, 1
33561, 34609, 0, "Selected statements contain a return statement but not all possible execution flows end in a return. Semantics may not be preserved if you proceed.", 0, 0, 15, 15, 11, 4, 4, 0
33626, 34514, 0, "Selected statements contain a return statement but not all possible execution flows end in a return. Semantics may not be preserved if you proceed.", 0, 0, 11, 11, 8, 3, 3, 0
33816, 34514, 0, "Selected statements contain a return statement but not all possible execution flows end in a return. Semantics may not be preserved if you proceed.", 0, 0, 9, 9, 6, 3, 3, 0
34524, 35096, 1, "OK", 1, 15, 7, 7, 5, 2, 2, 0
33713, 35022, 0, "Selected statements contain a return statement but not all possible execution flows end in a return. Semantics may not be preserved if you proceed.", 0, 0, 17, 17, 12, 5, 5, 0
33561, 35096, 1, "OK", 1, 49, 19, 19, 14, 5, 5, 0
34568, 34599, 1, "OK", 1, 1, 2, 1, 1, 0, 1, 1
33713, 34609, 0, "Selected statements contain a return statement but not all possible execution flows end in a return. Semantics may not be preserved if you proceed.", 0, 0, 13, 13, 9, 4, 4, 0
34658, 35012, 0, "Selected statements contain a return statement but not all possible execution flows end in a return. Semantics may not be preserved if you proceed.", 0, 0, 3, 2, 2, 0, 1, 1
33561, 33703, 0, "Selected statements contain a return statement but not all possible execution flows end in a return. Semantics may not be preserved if you proceed.", 0, 0, 2, 2, 2, 0, 0, 0