A, B, feasible, reason, parameters, extractedLOC, reductionCC, extractedMethodCC, accumulatedInherentComponent, accumulatedNestingComponent, numberNestingContributors, nesting
1018, 4345, 1, "OK", 1, 85, 24, 24, 16, 8, 8, 0
1217, 2274, 0, "Ambiguous return value: Selected block modifies more than one local variable used in subsequent code. Affected variables are:  double[][] p double[][] rx9 double[][] ry9", 0, 0, 13, 13, 9, 4, 4, 0
1073, 2644, 0, "Ambiguous return value: Selected block modifies more than one local variable used in subsequent code. Affected variables are:  double[][] p int maxinterval int lenp", 0, 0, 14, 14, 10, 4, 4, 0
1217, 4324, 0, "Ambiguous return value: Selected block modifies more than one local variable used in subsequent code. Affected variables are:  double[][] opoly9 int[] pind", 0, 0, 24, 24, 16, 8, 8, 0
3539, 4023, 0, "Ambiguous return value: Selected block modifies more than one local variable used in subsequent code. Affected variables are:  double[] interp int ic", 0, 0, 4, 2, 2, 0, 2, 1
1275, 2530, 0, "Ambiguous return value: Selected block modifies more than one local variable used in subsequent code. Affected variables are:  int maxinterval int lenp", 0, 0, 13, 13, 9, 4, 4, 0
3201, 4267, 0, "Ambiguous return value: Selected block modifies more than one local variable used in subsequent code. Affected variables are:  int[] pind int ic", 0, 0, 7, 7, 4, 3, 3, 0
1018, 2314, 1, "OK", 1, 28, 13, 13, 9, 4, 4, 0
970, 1758, 0, "Ambiguous return value: Selected block modifies more than one local variable used in subsequent code. Affected variables are:  double[][] p double[][] rx9 double[][] ry9", 0, 0, 9, 9, 5, 4, 4, 0
1217, 2294, 0, "Ambiguous return value: Selected block modifies more than one local variable used in subsequent code. Affected variables are:  double[][] p double[][] ry9", 0, 0, 13, 13, 9, 4, 4, 0
940, 2690, 0, "Ambiguous return value: Selected block modifies more than one local variable used in subsequent code. Affected variables are:  double[][] p int maxinterval double[][] opoly9", 0, 0, 14, 14, 10, 4, 4, 0
1319, 3230, 0, "Ambiguous return value: Selected block modifies more than one local variable used in subsequent code. Affected variables are:  double[][] opoly9 int[] head int[] tail int[] v4", 0, 0, 17, 17, 12, 5, 5, 0
1217, 4345, 1, "OK", 2, 78, 24, 24, 16, 8, 8, 0
1018, 4377, 1, "OK", 1, 86, 24, 24, 16, 8, 8, 0
1433, 1758, 1, "OK", 4, 6, 9, 9, 5, 4, 4, 0
1217, 2314, 1, "OK", 2, 21, 13, 13, 9, 4, 4, 0
1073, 2690, 0, "Ambiguous return value: Selected block modifies more than one local variable used in subsequent code. Affected variables are:  double[][] p int maxinterval double[][] opoly9", 0, 0, 14, 14, 10, 4, 4, 0
1275, 4626, 0, "Ambiguous return value: Selected block modifies more than one local variable used in subsequent code. Affected variables are:  List<Double> lower List<Double> upper", 0, 0, 25, 25, 17, 8, 8, 0
1217, 4377, 1, "OK", 2, 79, 24, 24, 16, 8, 8, 0
1018, 2356, 0, "Ambiguous return value: Selected block modifies more than one local variable used in subsequent code. Affected variables are:  double[][] p double[][] c9", 0, 0, 13, 13, 9, 4, 4, 0
1319, 3268, 0, "Ambiguous return value: Selected block modifies more than one local variable used in subsequent code. Affected variables are:  double[][] opoly9 int[] head int[] tail int[] v4", 0, 0, 17, 17, 12, 5, 5, 0
3125, 4626, 0, "Ambiguous return value: Selected block modifies more than one local variable used in subsequent code. Affected variables are:  List<Double> lower List<Double> upper", 0, 0, 8, 8, 5, 3, 3, 0
3335, 4267, 1, "OK", 8, 28, 7, 7, 4, 3, 3, 0
3201, 4324, 1, "OK", 6, 33, 7, 7, 4, 3, 3, 0
4513, 4626, 1, "OK", 3, 4, 1, 1, 1, 0, 0, 0
1018, 2379, 1, "OK", 1, 30, 13, 13, 9, 4, 4, 0
1275, 2605, 0, "Ambiguous return value: Selected block modifies more than one local variable used in subsequent code. Affected variables are:  int maxinterval int lenp", 0, 0, 14, 14, 10, 4, 4, 0
940, 2751, 0, "Ambiguous return value: Selected block modifies more than one local variable used in subsequent code. Affected variables are:  double[][] p int maxinterval double[][] opoly9 int[] head", 0, 0, 14, 14, 10, 4, 4, 0
1217, 2356, 0, "Ambiguous return value: Selected block modifies more than one local variable used in subsequent code. Affected variables are:  double[][] p double[][] c9", 0, 0, 13, 13, 9, 4, 4, 0
1275, 4655, 1, "OK", 3, 88, 25, 25, 17, 8, 8, 0
3201, 4345, 1, "OK", 6, 34, 7, 7, 4, 3, 3, 0
3125, 4655, 1, "OK", 6, 48, 8, 8, 5, 3, 3, 0
2517, 3035, 0, "Ambiguous return value: Selected block modifies more than one local variable used in subsequent code. Affected variables are:  double[][] opoly9 int[] head int[] tail", 0, 0, 4, 4, 3, 1, 1, 0
1319, 3312, 0, "Ambiguous return value: Selected block modifies more than one local variable used in subsequent code. Affected variables are:  double[][] opoly9 int[] head int[] tail int[] v4 int[] pind", 0, 0, 17, 17, 12, 5, 5, 0
1217, 2379, 1, "OK", 2, 23, 13, 13, 9, 4, 4, 0
4513, 4655, 1, "OK", 3, 6, 1, 1, 1, 0, 0, 0
1073, 2751, 0, "Ambiguous return value: Selected block modifies more than one local variable used in subsequent code. Affected variables are:  double[][] p int maxinterval double[][] opoly9 int[] head", 0, 0, 14, 14, 10, 4, 4, 0
1275, 4682, 1, "OK", 3, 89, 25, 25, 17, 8, 8, 0
2536, 4505, 0, "Ambiguous return value: Selected block modifies more than one local variable used in subsequent code. Affected variables are:  List<Double> lower List<Double> upper", 0, 0, 11, 11, 7, 4, 4, 0
3125, 4682, 1, "OK", 6, 49, 8, 8, 5, 3, 3, 0
3201, 4377, 1, "OK", 6, 35, 7, 7, 4, 3, 3, 0
1275, 2644, 0, "Ambiguous return value: Selected block modifies more than one local variable used in subsequent code. Affected variables are:  int maxinterval int lenp", 0, 0, 14, 14, 10, 4, 4, 0
1319, 3329, 0, "Ambiguous return value: Selected block modifies more than one local variable used in subsequent code. Affected variables are:  double[][] opoly9 int[] head int[] tail int[] v4 int[] pind int ic", 0, 0, 17, 17, 12, 5, 5, 0
3335, 4324, 1, "OK", 8, 29, 7, 7, 4, 3, 3, 0
2650, 3035, 0, "Ambiguous return value: Selected block modifies more than one local variable used in subsequent code. Affected variables are:  double[][] opoly9 int[] head int[] tail", 0, 0, 3, 3, 2, 1, 1, 0
3411, 4023, 0, "Ambiguous return value: Selected block modifies more than one local variable used in subsequent code. Affected variables are:  double[] interp int ic", 0, 0, 4, 2, 2, 0, 2, 1
2280, 4267, 0, "Ambiguous return value: Selected block modifies more than one local variable used in subsequent code. Affected variables are:  double[][] opoly9 int[] pind int ic", 0, 0, 11, 11, 7, 4, 4, 0
4513, 4682, 1, "OK", 3, 7, 1, 1, 1, 0, 0, 0
3800, 4260, 1, "OK", 9, 13, 4, 2, 2, 0, 2, 1
2320, 3035, 0, "Ambiguous return value: Selected block modifies more than one local variable used in subsequent code. Affected variables are:  double[][] opoly9 int[] head int[] tail", 0, 0, 4, 4, 3, 1, 1, 0
3335, 4345, 1, "OK", 8, 30, 7, 7, 4, 3, 3, 0
940, 2815, 0, "Ambiguous return value: Selected block modifies more than one local variable used in subsequent code. Affected variables are:  double[][] p int maxinterval double[][] opoly9 int[] head int[] tail", 0, 0, 14, 14, 10, 4, 4, 0
970, 1887, 0, "Ambiguous return value: Selected block modifies more than one local variable used in subsequent code. Affected variables are:  double[][] p double[][] rx9 double[][] ry9", 0, 0, 10, 10, 6, 4, 4, 0
2611, 4267, 0, "Ambiguous return value: Selected block modifies more than one local variable used in subsequent code. Affected variables are:  double[][] opoly9 int[] pind int ic", 0, 0, 10, 10, 6, 4, 4, 0
1018, 4505, 0, "Ambiguous return value: Selected block modifies more than one local variable used in subsequent code. Affected variables are:  List<Double> lower List<Double> upper", 0, 0, 24, 24, 16, 8, 8, 0
1433, 1887, 1, "OK", 4, 8, 10, 10, 6, 4, 4, 0
1275, 2690, 0, "Ambiguous return value: Selected block modifies more than one local variable used in subsequent code. Affected variables are:  int maxinterval double[][] opoly9", 0, 0, 14, 14, 10, 4, 4, 0
3867, 4260, 1, "OK", 8, 11, 4, 2, 2, 0, 2, 1
1198, 3035, 0, "Ambiguous return value: Selected block modifies more than one local variable used in subsequent code. Affected variables are:  double[][] p double[][] opoly9 int[] head int[] tail", 0, 0, 17, 17, 12, 5, 5, 0
1073, 2815, 0, "Ambiguous return value: Selected block modifies more than one local variable used in subsequent code. Affected variables are:  double[][] p int maxinterval double[][] opoly9 int[] head int[] tail", 0, 0, 14, 14, 10, 4, 4, 0
3335, 4377, 1, "OK", 8, 31, 7, 7, 4, 3, 3, 0
1018, 2481, 0, "Ambiguous return value: Selected block modifies more than one local variable used in subsequent code. Affected variables are:  double[][] p int maxinterval", 0, 0, 13, 13, 9, 4, 4, 0
1217, 4505, 0, "Ambiguous return value: Selected block modifies more than one local variable used in subsequent code. Affected variables are:  List<Double> lower List<Double> upper", 0, 0, 24, 24, 16, 8, 8, 0
1764, 1887, 1, "OK", 3, 2, 1, 1, 1, 0, 0, 0
2280, 4324, 0, "Ambiguous return value: Selected block modifies more than one local variable used in subsequent code. Affected variables are:  double[][] opoly9 int[] pind", 0, 0, 11, 11, 7, 4, 4, 0
4385, 4626, 0, "Ambiguous return value: Selected block modifies more than one local variable used in subsequent code. Affected variables are:  List<Double> lower List<Double> upper", 0, 0, 1, 1, 1, 0, 0, 0
1217, 2481, 0, "Ambiguous return value: Selected block modifies more than one local variable used in subsequent code. Affected variables are:  double[][] p int maxinterval", 0, 0, 13, 13, 9, 4, 4, 0
2280, 4345, 1, "OK", 4, 59, 11, 11, 7, 4, 4, 0
2611, 4324, 0, "Ambiguous return value: Selected block modifies more than one local variable used in subsequent code. Affected variables are:  double[][] opoly9 int[] pind", 0, 0, 10, 10, 6, 4, 4, 0
1018, 2511, 0, "Ambiguous return value: Selected block modifies more than one local variable used in subsequent code. Affected variables are:  double[][] p int maxinterval", 0, 0, 13, 13, 9, 4, 4, 0
2517, 3147, 0, "Ambiguous return value: Selected block modifies more than one local variable used in subsequent code. Affected variables are:  double[][] opoly9 int[] head int[] tail int[] v4", 0, 0, 4, 4, 3, 1, 1, 0
3491, 3673, 1, "OK", 5, 6, 2, 1, 1, 0, 1, 1
1893, 2016, 1, "OK", 3, 2, 1, 1, 1, 0, 0, 0
3274, 4267, 0, "Ambiguous return value: Selected block modifies more than one local variable used in subsequent code. Affected variables are:  int[] pind int ic", 0, 0, 7, 7, 4, 3, 3, 0
2151, 4267, 0, "Ambiguous return value: Selected block modifies more than one local variable used in subsequent code. Affected variables are:  double[][] opoly9 int[] pind int ic", 0, 0, 12, 12, 8, 4, 4, 0
1275, 2751, 0, "Ambiguous return value: Selected block modifies more than one local variable used in subsequent code. Affected variables are:  int maxinterval double[][] opoly9 int[] head", 0, 0, 14, 14, 10, 4, 4, 0
2517, 3160, 0, "Ambiguous return value: Selected block modifies more than one local variable used in subsequent code. Affected variables are:  double[][] opoly9 int[] head int[] tail int[] v4", 0, 0, 4, 4, 3, 1, 1, 0
2611, 4345, 1, "OK", 4, 48, 10, 10, 6, 4, 4, 0
1018, 2530, 0, "Ambiguous return value: Selected block modifies more than one local variable used in subsequent code. Affected variables are:  double[][] p int maxinterval int lenp", 0, 0, 13, 13, 9, 4, 4, 0
2536, 4626, 0, "Ambiguous return value: Selected block modifies more than one local variable used in subsequent code. Affected variables are:  List<Double> lower List<Double> upper", 0, 0, 12, 12, 8, 4, 4, 0
4385, 4655, 1, "OK", 1, 9, 1, 1, 1, 0, 0, 0
1217, 2511, 0, "Ambiguous return value: Selected block modifies more than one local variable used in subsequent code. Affected variables are:  double[][] p int maxinterval", 0, 0, 13, 13, 9, 4, 4, 0
2280, 4377, 1, "OK", 4, 60, 11, 11, 7, 4, 4, 0
2650, 3147, 0, "Ambiguous return value: Selected block modifies more than one local variable used in subsequent code. Affected variables are:  double[][] opoly9 int[] head int[] tail int[] v4", 0, 0, 3, 3, 2, 1, 1, 0
3539, 4260, 1, "OK", 8, 21, 6, 3, 3, 0, 3, 1
3201, 4505, 0, "Ambiguous return value: Selected block modifies more than one local variable used in subsequent code. Affected variables are:  List<Double> lower List<Double> upper", 0, 0, 7, 7, 4, 3, 3, 0
2022, 2145, 1, "OK", 3, 2, 1, 1, 1, 0, 0, 0
2320, 3147, 0, "Ambiguous return value: Selected block modifies more than one local variable used in subsequent code. Affected variables are:  double[][] opoly9 int[] head int[] tail int[] v4", 0, 0, 4, 4, 3, 1, 1, 0
2650, 3160, 0, "Ambiguous return value: Selected block modifies more than one local variable used in subsequent code. Affected variables are:  double[][] opoly9 int[] head int[] tail int[] v4", 0, 0, 3, 3, 2, 1, 1, 0
1217, 2530, 0, "Ambiguous return value: Selected block modifies more than one local variable used in subsequent code. Affected variables are:  double[][] p int maxinterval int lenp", 0, 0, 13, 13, 9, 4, 4, 0
2517, 3195, 0, "Ambiguous return value: Selected block modifies more than one local variable used in subsequent code. Affected variables are:  double[][] opoly9 int[] head int[] tail int[] v4", 0, 0, 4, 4, 3, 1, 1, 0
2611, 4377, 1, "OK", 4, 49, 10, 10, 6, 4, 4, 0
2536, 2605, 1, "OK", 2, 3, 1, 1, 1, 0, 0, 0
2320, 3160, 0, "Ambiguous return value: Selected block modifies more than one local variable used in subsequent code. Affected variables are:  double[][] opoly9 int[] head int[] tail int[] v4", 0, 0, 4, 4, 3, 1, 1, 0
4385, 4682, 1, "OK", 1, 10, 1, 1, 1, 0, 0, 0
2536, 4655, 1, "OK", 5, 62, 12, 12, 8, 4, 4, 0
970, 2016, 0, "Ambiguous return value: Selected block modifies more than one local variable used in subsequent code. Affected variables are:  double[][] p double[][] rx9 double[][] ry9", 0, 0, 11, 11, 7, 4, 4, 0
1018, 4626, 0, "Ambiguous return value: Selected block modifies more than one local variable used in subsequent code. Affected variables are:  List<Double> lower List<Double> upper", 0, 0, 25, 25, 17, 8, 8, 0
2417, 4267, 0, "Ambiguous return value: Selected block modifies more than one local variable used in subsequent code. Affected variables are:  double[][] opoly9 int[] pind int ic", 0, 0, 11, 11, 7, 4, 4, 0
3274, 4324, 1, "OK", 6, 31, 7, 7, 4, 3, 3, 0
2151, 2274, 1, "OK", 3, 2, 1, 1, 1, 0, 0, 0
1198, 3147, 0, "Ambiguous return value: Selected block modifies more than one local variable used in subsequent code. Affected variables are:  double[][] p double[][] opoly9 int[] head int[] tail int[] v4", 0, 0, 17, 17, 12, 5, 5, 0
3491, 3745, 1, "OK", 6, 9, 2, 1, 1, 0, 1, 1
2151, 4324, 0, "Ambiguous return value: Selected block modifies more than one local variable used in subsequent code. Affected variables are:  double[][] opoly9 int[] pind", 0, 0, 12, 12, 8, 4, 4, 0
2536, 4682, 1, "OK", 5, 63, 12, 12, 8, 4, 4, 0
2650, 3195, 0, "Ambiguous return value: Selected block modifies more than one local variable used in subsequent code. Affected variables are:  double[][] opoly9 int[] head int[] tail int[] v4", 0, 0, 3, 3, 2, 1, 1, 0
1275, 2815, 0, "Ambiguous return value: Selected block modifies more than one local variable used in subsequent code. Affected variables are:  int maxinterval double[][] opoly9 int[] head int[] tail", 0, 0, 14, 14, 10, 4, 4, 0
1433, 2016, 1, "OK", 4, 10, 11, 11, 7, 4, 4, 0
1198, 3160, 0, "Ambiguous return value: Selected block modifies more than one local variable used in subsequent code. Affected variables are:  double[][] p double[][] opoly9 int[] head int[] tail int[] v4", 0, 0, 17, 17, 12, 5, 5, 0
2517, 3230, 0, "Ambiguous return value: Selected block modifies more than one local variable used in subsequent code. Affected variables are:  double[][] opoly9 int[] head int[] tail int[] v4", 0, 0, 4, 4, 3, 1, 1, 0
2536, 2644, 1, "OK", 3, 4, 1, 1, 1, 0, 0, 0
2320, 3195, 0, "Ambiguous return value: Selected block modifies more than one local variable used in subsequent code. Affected variables are:  double[][] opoly9 int[] head int[] tail int[] v4", 0, 0, 4, 4, 3, 1, 1, 0
2151, 2294, 1, "OK", 4, 3, 1, 1, 1, 0, 0, 0
3274, 4345, 1, "OK", 6, 32, 7, 7, 4, 3, 3, 0
1217, 4626, 0, "Ambiguous return value: Selected block modifies more than one local variable used in subsequent code. Affected variables are:  List<Double> lower List<Double> upper", 0, 0, 25, 25, 17, 8, 8, 0
2151, 4345, 1, "OK", 4, 61, 12, 12, 8, 4, 4, 0
3335, 4505, 0, "Ambiguous return value: Selected block modifies more than one local variable used in subsequent code. Affected variables are:  List<Double> lower List<Double> upper", 0, 0, 7, 7, 4, 3, 3, 0
1018, 2605, 0, "Ambiguous return value: Selected block modifies more than one local variable used in subsequent code. Affected variables are:  double[][] p int maxinterval int lenp", 0, 0, 14, 14, 10, 4, 4, 0
1018, 4655, 1, "OK", 2, 96, 25, 25, 17, 8, 8, 0
1764, 2016, 1, "OK", 3, 4, 2, 2, 2, 0, 0, 0
1376, 1758, 1, "OK", 3, 7, 9, 9, 5, 4, 4, 0
2650, 3230, 0, "Ambiguous return value: Selected block modifies more than one local variable used in subsequent code. Affected variables are:  double[][] opoly9 int[] head int[] tail int[] v4", 0, 0, 3, 3, 2, 1, 1, 0
2151, 2314, 1, "OK", 4, 4, 1, 1, 1, 0, 0, 0
2022, 4267, 0, "Ambiguous return value: Selected block modifies more than one local variable used in subsequent code. Affected variables are:  double[][] opoly9 int[] pind int ic", 0, 0, 13, 13, 9, 4, 4, 0
1217, 2605, 0, "Ambiguous return value: Selected block modifies more than one local variable used in subsequent code. Affected variables are:  double[][] p int maxinterval int lenp", 0, 0, 14, 14, 10, 4, 4, 0
1198, 3195, 0, "Ambiguous return value: Selected block modifies more than one local variable used in subsequent code. Affected variables are:  double[][] p double[][] opoly9 int[] head int[] tail int[] v4", 0, 0, 17, 17, 12, 5, 5, 0
2320, 3230, 0, "Ambiguous return value: Selected block modifies more than one local variable used in subsequent code. Affected variables are:  double[][] opoly9 int[] head int[] tail int[] v4", 0, 0, 4, 4, 3, 1, 1, 0
1217, 4655, 1, "OK", 3, 89, 25, 25, 17, 8, 8, 0
3491, 3792, 0, "Ambiguous return value: Selected block modifies more than one local variable used in subsequent code. Affected variables are:  double[] kb1 double[] kb2", 0, 0, 2, 1, 1, 0, 1, 1
1018, 4682, 1, "OK", 2, 97, 25, 25, 17, 8, 8, 0
2517, 3268, 0, "Ambiguous return value: Selected block modifies more than one local variable used in subsequent code. Affected variables are:  double[][] opoly9 int[] head int[] tail int[] v4", 0, 0, 4, 4, 3, 1, 1, 0
3274, 4377, 1, "OK", 6, 33, 7, 7, 4, 3, 3, 0
2151, 4377, 1, "OK", 4, 62, 12, 12, 8, 4, 4, 0
2417, 4324, 0, "Ambiguous return value: Selected block modifies more than one local variable used in subsequent code. Affected variables are:  double[][] opoly9 int[] pind", 0, 0, 11, 11, 7, 4, 4, 0
2536, 2690, 1, "OK", 3, 5, 1, 1, 1, 0, 0, 0
1018, 2644, 0, "Ambiguous return value: Selected block modifies more than one local variable used in subsequent code. Affected variables are:  double[][] p int maxinterval int lenp", 0, 0, 14, 14, 10, 4, 4, 0
1893, 2145, 1, "OK", 4, 4, 2, 2, 2, 0, 0, 0
2417, 4345, 1, "OK", 2, 54, 11, 11, 7, 4, 4, 0
1217, 4682, 1, "OK", 3, 90, 25, 25, 17, 8, 8, 0
2650, 3268, 0, "Ambiguous return value: Selected block modifies more than one local variable used in subsequent code. Affected variables are:  double[][] opoly9 int[] head int[] tail int[] v4", 0, 0, 3, 3, 2, 1, 1, 0
2151, 2356, 1, "OK", 4, 5, 1, 1, 1, 0, 0, 0
940, 3035, 0, "Ambiguous return value: Selected block modifies more than one local variable used in subsequent code. Affected variables are:  double[][] p double[][] opoly9 int[] head int[] tail", 0, 0, 17, 17, 12, 5, 5, 0
1198, 3230, 0, "Ambiguous return value: Selected block modifies more than one local variable used in subsequent code. Affected variables are:  double[][] p double[][] opoly9 int[] head int[] tail int[] v4", 0, 0, 17, 17, 12, 5, 5, 0
2280, 4505, 0, "Ambiguous return value: Selected block modifies more than one local variable used in subsequent code. Affected variables are:  List<Double> lower List<Double> upper", 0, 0, 11, 11, 7, 4, 4, 0
3201, 4626, 0, "Ambiguous return value: Selected block modifies more than one local variable used in subsequent code. Affected variables are:  List<Double> lower List<Double> upper", 0, 0, 8, 8, 5, 3, 3, 0
3411, 4260, 1, "OK", 9, 26, 6, 3, 3, 0, 3, 1
1217, 2644, 0, "Ambiguous return value: Selected block modifies more than one local variable used in subsequent code. Affected variables are:  double[][] p int maxinterval int lenp", 0, 0, 14, 14, 10, 4, 4, 0
2320, 3268, 0, "Ambiguous return value: Selected block modifies more than one local variable used in subsequent code. Affected variables are:  double[][] opoly9 int[] head int[] tail int[] v4", 0, 0, 4, 4, 3, 1, 1, 0
3491, 3832, 1, "OK", 6, 11, 2, 1, 1, 0, 1, 1
2022, 2274, 1, "OK", 3, 4, 2, 2, 2, 0, 0, 0
2517, 3312, 0, "Ambiguous return value: Selected block modifies more than one local variable used in subsequent code. Affected variables are:  double[][] opoly9 int[] head int[] tail int[] v4 int[] pind", 0, 0, 4, 4, 3, 1, 1, 0
2022, 4324, 0, "Ambiguous return value: Selected block modifies more than one local variable used in subsequent code. Affected variables are:  double[][] opoly9 int[] pind", 0, 0, 13, 13, 9, 4, 4, 0
2151, 2379, 1, "OK", 4, 6, 1, 1, 1, 0, 0, 0
2611, 4505, 0, "Ambiguous return value: Selected block modifies more than one local variable used in subsequent code. Affected variables are:  List<Double> lower List<Double> upper", 0, 0, 10, 10, 6, 4, 4, 0
2417, 4377, 1, "OK", 2, 55, 11, 11, 7, 4, 4, 0
1018, 2690, 0, "Ambiguous return value: Selected block modifies more than one local variable used in subsequent code. Affected variables are:  double[][] p int maxinterval double[][] opoly9", 0, 0, 14, 14, 10, 4, 4, 0
1073, 3035, 0, "Ambiguous return value: Selected block modifies more than one local variable used in subsequent code. Affected variables are:  double[][] p double[][] opoly9 int[] head int[] tail", 0, 0, 17, 17, 12, 5, 5, 0
2517, 3329, 0, "Ambiguous return value: Selected block modifies more than one local variable used in subsequent code. Affected variables are:  double[][] opoly9 int[] head int[] tail int[] v4 int[] pind int ic", 0, 0, 4, 4, 3, 1, 1, 0
3201, 4655, 1, "OK", 7, 45, 8, 8, 5, 3, 3, 0
2022, 2294, 1, "OK", 4, 5, 2, 2, 2, 0, 0, 0
2487, 4267, 0, "Ambiguous return value: Selected block modifies more than one local variable used in subsequent code. Affected variables are:  double[][] opoly9 int[] pind int ic", 0, 0, 11, 11, 7, 4, 4, 0
2022, 4345, 1, "OK", 4, 63, 13, 13, 9, 4, 4, 0
2650, 3312, 0, "Ambiguous return value: Selected block modifies more than one local variable used in subsequent code. Affected variables are:  double[][] opoly9 int[] head int[] tail int[] v4 int[] pind", 0, 0, 3, 3, 2, 1, 1, 0
1198, 3268, 0, "Ambiguous return value: Selected block modifies more than one local variable used in subsequent code. Affected variables are:  double[][] p double[][] opoly9 int[] head int[] tail int[] v4", 0, 0, 17, 17, 12, 5, 5, 0
970, 2145, 0, "Ambiguous return value: Selected block modifies more than one local variable used in subsequent code. Affected variables are:  double[][] p double[][] rx9 double[][] ry9", 0, 0, 12, 12, 8, 4, 4, 0
2536, 2751, 0, "Ambiguous return value: Selected block modifies more than one local variable used in subsequent code. Affected variables are:  double[][] opoly9 int[] head", 0, 0, 1, 1, 1, 0, 0, 0
2320, 3312, 0, "Ambiguous return value: Selected block modifies more than one local variable used in subsequent code. Affected variables are:  double[][] opoly9 int[] head int[] tail int[] v4 int[] pind", 0, 0, 4, 4, 3, 1, 1, 0
1217, 2690, 0, "Ambiguous return value: Selected block modifies more than one local variable used in subsequent code. Affected variables are:  double[][] p int maxinterval double[][] opoly9", 0, 0, 14, 14, 10, 4, 4, 0
2022, 2314, 1, "OK", 4, 6, 2, 2, 2, 0, 0, 0
1893, 4267, 0, "Ambiguous return value: Selected block modifies more than one local variable used in subsequent code. Affected variables are:  double[][] opoly9 int[] pind int ic", 0, 0, 14, 14, 10, 4, 4, 0
1433, 2145, 1, "OK", 4, 12, 12, 12, 8, 4, 4, 0
2650, 3329, 0, "Ambiguous return value: Selected block modifies more than one local variable used in subsequent code. Affected variables are:  double[][] opoly9 int[] head int[] tail int[] v4 int[] pind int ic", 0, 0, 3, 3, 2, 1, 1, 0
3201, 4682, 1, "OK", 7, 46, 8, 8, 5, 3, 3, 0
3335, 4626, 0, "Ambiguous return value: Selected block modifies more than one local variable used in subsequent code. Affected variables are:  List<Double> lower List<Double> upper", 0, 0, 8, 8, 5, 3, 3, 0
2320, 3329, 0, "Ambiguous return value: Selected block modifies more than one local variable used in subsequent code. Affected variables are:  double[][] opoly9 int[] head int[] tail int[] v4 int[] pind int ic", 0, 0, 4, 4, 3, 1, 1, 0
2022, 4377, 1, "OK", 4, 64, 13, 13, 9, 4, 4, 0
1764, 2145, 1, "OK", 4, 6, 3, 3, 3, 0, 0, 0
1376, 1887, 1, "OK", 3, 9, 10, 10, 6, 4, 4, 0
1198, 3312, 0, "Ambiguous return value: Selected block modifies more than one local variable used in subsequent code. Affected variables are:  double[][] p double[][] opoly9 int[] head int[] tail int[] v4 int[] pind", 0, 0, 17, 17, 12, 5, 5, 0
1050, 1758, 0, "Ambiguous return value: Selected block modifies more than one local variable used in subsequent code. Affected variables are:  double[][] p double[][] rx9 double[][] ry9", 0, 0, 9, 9, 5, 4, 4, 0
1018, 2751, 0, "Ambiguous return value: Selected block modifies more than one local variable used in subsequent code. Affected variables are:  double[][] p int maxinterval double[][] opoly9 int[] head", 0, 0, 14, 14, 10, 4, 4, 0
3335, 4655, 1, "OK", 9, 41, 8, 8, 5, 3, 3, 0
2022, 2356, 1, "OK", 4, 7, 2, 2, 2, 0, 0, 0
2487, 4324, 0, "Ambiguous return value: Selected block modifies more than one local variable used in subsequent code. Affected variables are:  double[][] opoly9 int[] pind", 0, 0, 11, 11, 7, 4, 4, 0
3274, 4505, 0, "Ambiguous return value: Selected block modifies more than one local variable used in subsequent code. Affected variables are:  List<Double> lower List<Double> upper", 0, 0, 7, 7, 4, 3, 3, 0
2151, 4505, 0, "Ambiguous return value: Selected block modifies more than one local variable used in subsequent code. Affected variables are:  List<Double> lower List<Double> upper", 0, 0, 12, 12, 8, 4, 4, 0
1198, 3329, 0, "Ambiguous return value: Selected block modifies more than one local variable used in subsequent code. Affected variables are:  double[][] p double[][] opoly9 int[] head int[] tail int[] v4 int[] pind int ic", 0, 0, 17, 17, 12, 5, 5, 0
2536, 2815, 0, "Ambiguous return value: Selected block modifies more than one local variable used in subsequent code. Affected variables are:  double[][] opoly9 int[] head int[] tail", 0, 0, 1, 1, 1, 0, 0, 0
1893, 2274, 1, "OK", 4, 6, 3, 3, 3, 0, 0, 0
1217, 2751, 0, "Ambiguous return value: Selected block modifies more than one local variable used in subsequent code. Affected variables are:  double[][] p int maxinterval double[][] opoly9 int[] head", 0, 0, 14, 14, 10, 4, 4, 0
940, 3147, 0, "Ambiguous return value: Selected block modifies more than one local variable used in subsequent code. Affected variables are:  double[][] p double[][] opoly9 int[] head int[] tail int[] v4", 0, 0, 17, 17, 12, 5, 5, 0
1893, 4324, 0, "Ambiguous return value: Selected block modifies more than one local variable used in subsequent code. Affected variables are:  double[][] opoly9 int[] pind", 0, 0, 14, 14, 10, 4, 4, 0
970, 4267, 0, "Ambiguous return value: Selected block modifies more than one local variable used in subsequent code. Affected variables are:  double[][] opoly9 int[] pind int ic", 0, 0, 24, 24, 16, 8, 8, 0
2487, 4345, 1, "OK", 3, 53, 11, 11, 7, 4, 4, 0
3335, 4682, 1, "OK", 9, 42, 8, 8, 5, 3, 3, 0
2022, 2379, 1, "OK", 4, 8, 2, 2, 2, 0, 0, 0
2151, 2481, 1, "OK", 4, 8, 1, 1, 1, 0, 0, 0
2280, 4626, 0, "Ambiguous return value: Selected block modifies more than one local variable used in subsequent code. Affected variables are:  List<Double> lower List<Double> upper", 0, 0, 12, 12, 8, 4, 4, 0
940, 3160, 0, "Ambiguous return value: Selected block modifies more than one local variable used in subsequent code. Affected variables are:  double[][] p double[][] opoly9 int[] head int[] tail int[] v4", 0, 0, 17, 17, 12, 5, 5, 0
3753, 4023, 0, "Ambiguous return value: Selected block modifies more than one local variable used in subsequent code. Affected variables are:  double[] interp int ic", 0, 0, 2, 1, 1, 0, 1, 1
1893, 2294, 1, "OK", 4, 7, 3, 3, 3, 0, 0, 0
1433, 4267, 0, "Ambiguous return value: Selected block modifies more than one local variable used in subsequent code. Affected variables are:  double[][] opoly9 int[] pind int ic", 0, 0, 24, 24, 16, 8, 8, 0
1893, 4345, 1, "OK", 4, 65, 14, 14, 10, 4, 4, 0
1073, 3147, 0, "Ambiguous return value: Selected block modifies more than one local variable used in subsequent code. Affected variables are:  double[][] p double[][] opoly9 int[] head int[] tail int[] v4", 0, 0, 17, 17, 12, 5, 5, 0
1275, 3035, 0, "Ambiguous return value: Selected block modifies more than one local variable used in subsequent code. Affected variables are:  double[][] opoly9 int[] head int[] tail", 0, 0, 17, 17, 12, 5, 5, 0
2611, 4626, 0, "Ambiguous return value: Selected block modifies more than one local variable used in subsequent code. Affected variables are:  List<Double> lower List<Double> upper", 0, 0, 11, 11, 7, 4, 4, 0
2487, 4377, 1, "OK", 3, 54, 11, 11, 7, 4, 4, 0
1018, 2815, 0, "Ambiguous return value: Selected block modifies more than one local variable used in subsequent code. Affected variables are:  double[][] p int maxinterval double[][] opoly9 int[] head int[] tail", 0, 0, 14, 14, 10, 4, 4, 0
1893, 2314, 1, "OK", 4, 8, 3, 3, 3, 0, 0, 0
2280, 2605, 0, "Ambiguous return value: Selected block modifies more than one local variable used in subsequent code. Affected variables are:  int maxinterval int lenp", 0, 0, 1, 1, 1, 0, 0, 0
1073, 3160, 0, "Ambiguous return value: Selected block modifies more than one local variable used in subsequent code. Affected variables are:  double[][] p double[][] opoly9 int[] head int[] tail int[] v4", 0, 0, 17, 17, 12, 5, 5, 0
1764, 4267, 0, "Ambiguous return value: Selected block modifies more than one local variable used in subsequent code. Affected variables are:  double[][] opoly9 int[] pind int ic", 0, 0, 15, 15, 11, 4, 4, 0
2151, 2511, 1, "OK", 4, 9, 1, 1, 1, 0, 0, 0
2417, 4505, 0, "Ambiguous return value: Selected block modifies more than one local variable used in subsequent code. Affected variables are:  List<Double> lower List<Double> upper", 0, 0, 11, 11, 7, 4, 4, 0
2280, 4655, 1, "OK", 5, 70, 12, 12, 8, 4, 4, 0
3567, 3673, 1, "OK", 2, 3, 2, 1, 1, 0, 1, 1
940, 3195, 0, "Ambiguous return value: Selected block modifies more than one local variable used in subsequent code. Affected variables are:  double[][] p double[][] opoly9 int[] head int[] tail int[] v4", 0, 0, 17, 17, 12, 5, 5, 0
1893, 4377, 1, "OK", 4, 66, 14, 14, 10, 4, 4, 0
970, 2274, 0, "Ambiguous return value: Selected block modifies more than one local variable used in subsequent code. Affected variables are:  double[][] p double[][] rx9 double[][] ry9", 0, 0, 13, 13, 9, 4, 4, 0
970, 4324, 0, "Ambiguous return value: Selected block modifies more than one local variable used in subsequent code. Affected variables are:  double[][] opoly9 int[] pind", 0, 0, 24, 24, 16, 8, 8, 0
2611, 4655, 1, "OK", 5, 59, 11, 11, 7, 4, 4, 0
2151, 2530, 0, "Ambiguous return value: Selected block modifies more than one local variable used in subsequent code. Affected variables are:  int maxinterval int lenp", 0, 0, 1, 1, 1, 0, 0, 0
1217, 2815, 0, "Ambiguous return value: Selected block modifies more than one local variable used in subsequent code. Affected variables are:  double[][] p int maxinterval double[][] opoly9 int[] head int[] tail", 0, 0, 14, 14, 10, 4, 4, 0
2280, 4682, 1, "OK", 5, 71, 12, 12, 8, 4, 4, 0
1433, 2274, 1, "OK", 4, 14, 13, 13, 9, 4, 4, 0
1073, 3195, 0, "Ambiguous return value: Selected block modifies more than one local variable used in subsequent code. Affected variables are:  double[][] p double[][] opoly9 int[] head int[] tail int[] v4", 0, 0, 17, 17, 12, 5, 5, 0
4330, 4626, 0, "Ambiguous return value: Selected block modifies more than one local variable used in subsequent code. Affected variables are:  List<Double> lower List<Double> upper", 0, 0, 1, 1, 1, 0, 0, 0
1433, 4324, 0, "Ambiguous return value: Selected block modifies more than one local variable used in subsequent code. Affected variables are:  double[][] opoly9 int[] pind", 0, 0, 24, 24, 16, 8, 8, 0
2280, 2644, 0, "Ambiguous return value: Selected block modifies more than one local variable used in subsequent code. Affected variables are:  int maxinterval int lenp", 0, 0, 1, 1, 1, 0, 0, 0
970, 2294, 0, "Ambiguous return value: Selected block modifies more than one local variable used in subsequent code. Affected variables are:  double[][] p double[][] ry9", 0, 0, 13, 13, 9, 4, 4, 0
970, 4345, 1, "OK", 1, 86, 24, 24, 16, 8, 8, 0
1893, 2356, 1, "OK", 4, 9, 3, 3, 3, 0, 0, 0
940, 3230, 0, "Ambiguous return value: Selected block modifies more than one local variable used in subsequent code. Affected variables are:  double[][] p double[][] opoly9 int[] head int[] tail int[] v4", 0, 0, 17, 17, 12, 5, 5, 0
3491, 4023, 0, "Ambiguous return value: Selected block modifies more than one local variable used in subsequent code. Affected variables are:  double[] interp int ic", 0, 0, 4, 2, 2, 0, 2, 1
2022, 4505, 0, "Ambiguous return value: Selected block modifies more than one local variable used in subsequent code. Affected variables are:  List<Double> lower List<Double> upper", 0, 0, 13, 13, 9, 4, 4, 0
2611, 4682, 1, "OK", 5, 60, 11, 11, 7, 4, 4, 0
3153, 4267, 0, "Ambiguous return value: Selected block modifies more than one local variable used in subsequent code. Affected variables are:  int[] pind int ic", 0, 0, 7, 7, 4, 3, 3, 0
1433, 2294, 1, "OK", 4, 15, 13, 13, 9, 4, 4, 0
1764, 2274, 1, "OK", 4, 8, 4, 4, 4, 0, 0, 0
970, 2314, 1, "OK", 1, 29, 13, 13, 9, 4, 4, 0
1376, 2016, 1, "OK", 3, 11, 11, 11, 7, 4, 4, 0
1433, 4345, 1, "OK", 4, 73, 24, 24, 16, 8, 8, 0
1764, 4324, 0, "Ambiguous return value: Selected block modifies more than one local variable used in subsequent code. Affected variables are:  double[][] opoly9 int[] pind", 0, 0, 15, 15, 11, 4, 4, 0
4330, 4655, 1, "OK", 3, 12, 1, 1, 1, 0, 0, 0
1050, 1887, 0, "Ambiguous return value: Selected block modifies more than one local variable used in subsequent code. Affected variables are:  double[][] p double[][] rx9 double[][] ry9", 0, 0, 10, 10, 6, 4, 4, 0
1893, 2379, 1, "OK", 4, 10, 3, 3, 3, 0, 0, 0
3274, 4626, 0, "Ambiguous return value: Selected block modifies more than one local variable used in subsequent code. Affected variables are:  List<Double> lower List<Double> upper", 0, 0, 8, 8, 5, 3, 3, 0
2022, 2481, 1, "OK", 4, 10, 2, 2, 2, 0, 0, 0
2151, 4626, 0, "Ambiguous return value: Selected block modifies more than one local variable used in subsequent code. Affected variables are:  List<Double> lower List<Double> upper", 0, 0, 13, 13, 9, 4, 4, 0
1073, 3230, 0, "Ambiguous return value: Selected block modifies more than one local variable used in subsequent code. Affected variables are:  double[][] p double[][] opoly9 int[] head int[] tail int[] v4", 0, 0, 17, 17, 12, 5, 5, 0
970, 4377, 1, "OK", 1, 87, 24, 24, 16, 8, 8, 0
1433, 2314, 1, "OK", 4, 16, 13, 13, 9, 4, 4, 0
3567, 3745, 1, "OK", 3, 6, 2, 1, 1, 0, 1, 1
1764, 2294, 1, "OK", 4, 9, 4, 4, 4, 0, 0, 0
1764, 4345, 1, "OK", 4, 67, 15, 15, 11, 4, 4, 0
1319, 1758, 0, "Ambiguous return value: Selected block modifies more than one local variable used in subsequent code. Affected variables are:  double[][] rx9 double[][] ry9", 0, 0, 9, 9, 5, 4, 4, 0
940, 3268, 0, "Ambiguous return value: Selected block modifies more than one local variable used in subsequent code. Affected variables are:  double[][] p double[][] opoly9 int[] head int[] tail int[] v4", 0, 0, 17, 17, 12, 5, 5, 0
2280, 2690, 0, "Ambiguous return value: Selected block modifies more than one local variable used in subsequent code. Affected variables are:  int maxinterval double[][] opoly9", 0, 0, 1, 1, 1, 0, 0, 0
1433, 4377, 1, "OK", 4, 74, 24, 24, 16, 8, 8, 0
4330, 4682, 1, "OK", 3, 13, 1, 1, 1, 0, 0, 0
2824, 4267, 0, "Ambiguous return value: Selected block modifies more than one local variable used in subsequent code. Affected variables are:  int[] pind int ic", 0, 0, 10, 10, 6, 4, 4, 0
2151, 2605, 0, "Ambiguous return value: Selected block modifies more than one local variable used in subsequent code. Affected variables are:  int maxinterval int lenp", 0, 0, 2, 2, 2, 0, 0, 0
1764, 2314, 1, "OK", 4, 10, 4, 4, 4, 0, 0, 0
3274, 4655, 1, "OK", 7, 43, 8, 8, 5, 3, 3, 0
2151, 4655, 1, "OK", 5, 72, 13, 13, 9, 4, 4, 0
970, 2356, 0, "Ambiguous return value: Selected block modifies more than one local variable used in subsequent code. Affected variables are:  double[][] p double[][] c9", 0, 0, 13, 13, 9, 4, 4, 0
2022, 2511, 1, "OK", 4, 11, 2, 2, 2, 0, 0, 0
1275, 3147, 0, "Ambiguous return value: Selected block modifies more than one local variable used in subsequent code. Affected variables are:  double[][] opoly9 int[] head int[] tail int[] v4", 0, 0, 17, 17, 12, 5, 5, 0
2362, 4267, 0, "Ambiguous return value: Selected block modifies more than one local variable used in subsequent code. Affected variables are:  double[][] opoly9 int[] pind int ic", 0, 0, 11, 11, 7, 4, 4, 0
1073, 3268, 0, "Ambiguous return value: Selected block modifies more than one local variable used in subsequent code. Affected variables are:  double[][] p double[][] opoly9 int[] head int[] tail int[] v4", 0, 0, 17, 17, 12, 5, 5, 0
3153, 4324, 1, "OK", 6, 35, 7, 7, 4, 3, 3, 0
1764, 4377, 1, "OK", 4, 68, 15, 15, 11, 4, 4, 0
1433, 2356, 1, "OK", 4, 17, 13, 13, 9, 4, 4, 0
2022, 2530, 0, "Ambiguous return value: Selected block modifies more than one local variable used in subsequent code. Affected variables are:  int maxinterval int lenp", 0, 0, 2, 2, 2, 0, 0, 0
1275, 3160, 0, "Ambiguous return value: Selected block modifies more than one local variable used in subsequent code. Affected variables are:  double[][] opoly9 int[] head int[] tail int[] v4", 0, 0, 17, 17, 12, 5, 5, 0
3274, 4682, 1, "OK", 7, 44, 8, 8, 5, 3, 3, 0
970, 2379, 1, "OK", 1, 31, 13, 13, 9, 4, 4, 0
2487, 4505, 0, "Ambiguous return value: Selected block modifies more than one local variable used in subsequent code. Affected variables are:  List<Double> lower List<Double> upper", 0, 0, 11, 11, 7, 4, 4, 0
2417, 4626, 0, "Ambiguous return value: Selected block modifies more than one local variable used in subsequent code. Affected variables are:  List<Double> lower List<Double> upper", 0, 0, 12, 12, 8, 4, 4, 0
3567, 3792, 0, "Ambiguous return value: Selected block modifies more than one local variable used in subsequent code. Affected variables are:  double[] kb1 double[] kb2", 0, 0, 2, 1, 1, 0, 1, 1
940, 3312, 0, "Ambiguous return value: Selected block modifies more than one local variable used in subsequent code. Affected variables are:  double[][] p double[][] opoly9 int[] head int[] tail int[] v4 int[] pind", 0, 0, 17, 17, 12, 5, 5, 0
2151, 4682, 1, "OK", 5, 73, 13, 13, 9, 4, 4, 0
3153, 4345, 1, "OK", 6, 36, 7, 7, 4, 3, 3, 0
2151, 2644, 0, "Ambiguous return value: Selected block modifies more than one local variable used in subsequent code. Affected variables are:  int maxinterval int lenp", 0, 0, 2, 2, 2, 0, 0, 0
1764, 2356, 1, "OK", 4, 11, 4, 4, 4, 0, 0, 0
1433, 2379, 1, "OK", 4, 18, 13, 13, 9, 4, 4, 0
1893, 4505, 0, "Ambiguous return value: Selected block modifies more than one local variable used in subsequent code. Affected variables are:  List<Double> lower List<Double> upper", 0, 0, 14, 14, 10, 4, 4, 0
940, 3329, 0, "Ambiguous return value: Selected block modifies more than one local variable used in subsequent code. Affected variables are:  double[][] p double[][] opoly9 int[] head int[] tail int[] v4 int[] pind int ic", 0, 0, 17, 17, 12, 5, 5, 0
2280, 2751, 0, "Ambiguous return value: Selected block modifies more than one local variable used in subsequent code. Affected variables are:  int maxinterval double[][] opoly9 int[] head", 0, 0, 1, 1, 1, 0, 0, 0
2417, 2605, 0, "Ambiguous return value: Selected block modifies more than one local variable used in subsequent code. Affected variables are:  int maxinterval int lenp", 0, 0, 1, 1, 1, 0, 0, 0
2824, 4324, 1, "OK", 6, 43, 10, 10, 6, 4, 4, 0
2417, 4655, 1, "OK", 3, 65, 12, 12, 8, 4, 4, 0
1073, 3312, 0, "Ambiguous return value: Selected block modifies more than one local variable used in subsequent code. Affected variables are:  double[][] p double[][] opoly9 int[] head int[] tail int[] v4 int[] pind", 0, 0, 17, 17, 12, 5, 5, 0
1275, 3195, 0, "Ambiguous return value: Selected block modifies more than one local variable used in subsequent code. Affected variables are:  double[][] opoly9 int[] head int[] tail int[] v4", 0, 0, 17, 17, 12, 5, 5, 0
2760, 4267, 0, "Ambiguous return value: Selected block modifies more than one local variable used in subsequent code. Affected variables are:  int[] pind int ic", 0, 0, 10, 10, 6, 4, 4, 0
1764, 2379, 1, "OK", 4, 12, 4, 4, 4, 0, 0, 0
3153, 4377, 1, "OK", 6, 37, 7, 7, 4, 3, 3, 0
2362, 4324, 0, "Ambiguous return value: Selected block modifies more than one local variable used in subsequent code. Affected variables are:  double[][] opoly9 int[] pind", 0, 0, 11, 11, 7, 4, 4, 0
3567, 3832, 1, "OK", 3, 8, 2, 1, 1, 0, 1, 1
2022, 4626, 0, "Ambiguous return value: Selected block modifies more than one local variable used in subsequent code. Affected variables are:  List<Double> lower List<Double> upper", 0, 0, 14, 14, 10, 4, 4, 0
1893, 2481, 1, "OK", 4, 12, 3, 3, 3, 0, 0, 0
1073, 3329, 0, "Ambiguous return value: Selected block modifies more than one local variable used in subsequent code. Affected variables are:  double[][] p double[][] opoly9 int[] head int[] tail int[] v4 int[] pind int ic", 0, 0, 17, 17, 12, 5, 5, 0
2824, 4345, 1, "OK", 6, 44, 10, 10, 6, 4, 4, 0
2536, 3035, 0, "Ambiguous return value: Selected block modifies more than one local variable used in subsequent code. Affected variables are:  double[][] opoly9 int[] head int[] tail", 0, 0, 4, 4, 3, 1, 1, 0
2417, 4682, 1, "OK", 3, 66, 12, 12, 8, 4, 4, 0
2151, 2690, 0, "Ambiguous return value: Selected block modifies more than one local variable used in subsequent code. Affected variables are:  int maxinterval double[][] opoly9", 0, 0, 2, 2, 2, 0, 0, 0
2362, 4345, 1, "OK", 3, 56, 11, 11, 7, 4, 4, 0
1376, 2145, 1, "OK", 3, 13, 12, 12, 8, 4, 4, 0
1275, 3230, 0, "Ambiguous return value: Selected block modifies more than one local variable used in subsequent code. Affected variables are:  double[][] opoly9 int[] head int[] tail int[] v4", 0, 0, 17, 17, 12, 5, 5, 0
2417, 2644, 0, "Ambiguous return value: Selected block modifies more than one local variable used in subsequent code. Affected variables are:  int maxinterval int lenp", 0, 0, 1, 1, 1, 0, 0, 0
1050, 2016, 0, "Ambiguous return value: Selected block modifies more than one local variable used in subsequent code. Affected variables are:  double[][] p double[][] rx9 double[][] ry9", 0, 0, 11, 11, 7, 4, 4, 0
2022, 2605, 0, "Ambiguous return value: Selected block modifies more than one local variable used in subsequent code. Affected variables are:  int maxinterval int lenp", 0, 0, 3, 3, 3, 0, 0, 0
1893, 2511, 1, "OK", 4, 13, 3, 3, 3, 0, 0, 0
2022, 4655, 1, "OK", 5, 74, 14, 14, 10, 4, 4, 0
970, 4505, 0, "Ambiguous return value: Selected block modifies more than one local variable used in subsequent code. Affected variables are:  List<Double> lower List<Double> upper", 0, 0, 24, 24, 16, 8, 8, 0
2824, 4377, 1, "OK", 6, 45, 10, 10, 6, 4, 4, 0
1319, 1887, 0, "Ambiguous return value: Selected block modifies more than one local variable used in subsequent code. Affected variables are:  double[][] rx9 double[][] ry9", 0, 0, 10, 10, 6, 4, 4, 0
2280, 2815, 0, "Ambiguous return value: Selected block modifies more than one local variable used in subsequent code. Affected variables are:  int maxinterval double[][] opoly9 int[] head int[] tail", 0, 0, 1, 1, 1, 0, 0, 0
2760, 4324, 1, "OK", 5, 44, 10, 10, 6, 4, 4, 0
3753, 4260, 1, "OK", 9, 14, 4, 2, 2, 0, 2, 1
1893, 2530, 0, "Ambiguous return value: Selected block modifies more than one local variable used in subsequent code. Affected variables are:  int maxinterval int lenp", 0, 0, 3, 3, 3, 0, 0, 0
1433, 4505, 0, "Ambiguous return value: Selected block modifies more than one local variable used in subsequent code. Affected variables are:  List<Double> lower List<Double> upper", 0, 0, 24, 24, 16, 8, 8, 0
2362, 4377, 1, "OK", 3, 57, 11, 11, 7, 4, 4, 0
1018, 3035, 0, "Ambiguous return value: Selected block modifies more than one local variable used in subsequent code. Affected variables are:  double[][] p double[][] opoly9 int[] head int[] tail", 0, 0, 17, 17, 12, 5, 5, 0
2022, 4682, 1, "OK", 5, 75, 14, 14, 10, 4, 4, 0
2696, 4267, 0, "Ambiguous return value: Selected block modifies more than one local variable used in subsequent code. Affected variables are:  int[] pind int ic", 0, 0, 10, 10, 6, 4, 4, 0
970, 2481, 0, "Ambiguous return value: Selected block modifies more than one local variable used in subsequent code. Affected variables are:  double[][] p int maxinterval", 0, 0, 13, 13, 9, 4, 4, 0
1275, 3268, 0, "Ambiguous return value: Selected block modifies more than one local variable used in subsequent code. Affected variables are:  double[][] opoly9 int[] head int[] tail int[] v4", 0, 0, 17, 17, 12, 5, 5, 0
2022, 2644, 0, "Ambiguous return value: Selected block modifies more than one local variable used in subsequent code. Affected variables are:  int maxinterval int lenp", 0, 0, 3, 3, 3, 0, 0, 0
2300, 4267, 0, "Ambiguous return value: Selected block modifies more than one local variable used in subsequent code. Affected variables are:  double[][] opoly9 int[] pind int ic", 0, 0, 11, 11, 7, 4, 4, 0
2417, 2690, 0, "Ambiguous return value: Selected block modifies more than one local variable used in subsequent code. Affected variables are:  int maxinterval double[][] opoly9", 0, 0, 1, 1, 1, 0, 0, 0
2760, 4345, 1, "OK", 5, 45, 10, 10, 6, 4, 4, 0
1764, 4505, 0, "Ambiguous return value: Selected block modifies more than one local variable used in subsequent code. Affected variables are:  List<Double> lower List<Double> upper", 0, 0, 15, 15, 11, 4, 4, 0
2151, 2751, 0, "Ambiguous return value: Selected block modifies more than one local variable used in subsequent code. Affected variables are:  int maxinterval double[][] opoly9 int[] head", 0, 0, 2, 2, 2, 0, 0, 0
1433, 2481, 1, "OK", 4, 20, 13, 13, 9, 4, 4, 0
1217, 3035, 0, "Ambiguous return value: Selected block modifies more than one local variable used in subsequent code. Affected variables are:  double[][] p double[][] opoly9 int[] head int[] tail", 0, 0, 17, 17, 12, 5, 5, 0
2487, 4626, 0, "Ambiguous return value: Selected block modifies more than one local variable used in subsequent code. Affected variables are:  List<Double> lower List<Double> upper", 0, 0, 12, 12, 8, 4, 4, 0
970, 2511, 0, "Ambiguous return value: Selected block modifies more than one local variable used in subsequent code. Affected variables are:  double[][] p int maxinterval", 0, 0, 13, 13, 9, 4, 4, 0
1376, 4267, 0, "Ambiguous return value: Selected block modifies more than one local variable used in subsequent code. Affected variables are:  double[][] opoly9 int[] pind int ic", 0, 0, 24, 24, 16, 8, 8, 0
1764, 2481, 1, "OK", 4, 14, 4, 4, 4, 0, 0, 0
1893, 4626, 0, "Ambiguous return value: Selected block modifies more than one local variable used in subsequent code. Affected variables are:  List<Double> lower List<Double> upper", 0, 0, 15, 15, 11, 4, 4, 0
2760, 4377, 1, "OK", 5, 46, 10, 10, 6, 4, 4, 0
1275, 3312, 0, "Ambiguous return value: Selected block modifies more than one local variable used in subsequent code. Affected variables are:  double[][] opoly9 int[] head int[] tail int[] v4 int[] pind", 0, 0, 17, 17, 12, 5, 5, 0
2487, 2605, 1, "OK", 1, 5, 1, 1, 1, 0, 0, 0
1433, 2511, 1, "OK", 4, 21, 13, 13, 9, 4, 4, 0
2487, 4655, 1, "OK", 4, 64, 12, 12, 8, 4, 4, 0
970, 2530, 0, "Ambiguous return value: Selected block modifies more than one local variable used in subsequent code. Affected variables are:  double[][] p int maxinterval int lenp", 0, 0, 13, 13, 9, 4, 4, 0
2022, 2690, 0, "Ambiguous return value: Selected block modifies more than one local variable used in subsequent code. Affected variables are:  int maxinterval double[][] opoly9", 0, 0, 3, 3, 3, 0, 0, 0
2696, 4324, 1, "OK", 4, 45, 10, 10, 6, 4, 4, 0
3491, 4260, 1, "OK", 8, 23, 6, 3, 3, 0, 3, 1
2536, 3147, 0, "Ambiguous return value: Selected block modifies more than one local variable used in subsequent code. Affected variables are:  double[][] opoly9 int[] head int[] tail int[] v4", 0, 0, 4, 4, 3, 1, 1, 0
1275, 3329, 0, "Ambiguous return value: Selected block modifies more than one local variable used in subsequent code. Affected variables are:  double[][] opoly9 int[] head int[] tail int[] v4 int[] pind int ic", 0, 0, 17, 17, 12, 5, 5, 0
2300, 4324, 0, "Ambiguous return value: Selected block modifies more than one local variable used in subsequent code. Affected variables are:  double[][] opoly9 int[] pind", 0, 0, 11, 11, 7, 4, 4, 0
3153, 4505, 0, "Ambiguous return value: Selected block modifies more than one local variable used in subsequent code. Affected variables are:  List<Double> lower List<Double> upper", 0, 0, 7, 7, 4, 3, 3, 0
1893, 2605, 0, "Ambiguous return value: Selected block modifies more than one local variable used in subsequent code. Affected variables are:  int maxinterval int lenp", 0, 0, 4, 4, 4, 0, 0, 0
1433, 2530, 0, "Ambiguous return value: Selected block modifies more than one local variable used in subsequent code. Affected variables are:  int maxinterval int lenp", 0, 0, 13, 13, 9, 4, 4, 0
1893, 4655, 1, "OK", 5, 76, 15, 15, 11, 4, 4, 0
1764, 2511, 1, "OK", 4, 15, 4, 4, 4, 0, 0, 0
2417, 2751, 0, "Ambiguous return value: Selected block modifies more than one local variable used in subsequent code. Affected variables are:  int maxinterval double[][] opoly9 int[] head", 0, 0, 1, 1, 1, 0, 0, 0
2536, 3160, 0, "Ambiguous return value: Selected block modifies more than one local variable used in subsequent code. Affected variables are:  double[][] opoly9 int[] head int[] tail int[] v4", 0, 0, 4, 4, 3, 1, 1, 0
2696, 4345, 1, "OK", 4, 46, 10, 10, 6, 4, 4, 0
2487, 4682, 1, "OK", 4, 65, 12, 12, 8, 4, 4, 0
2151, 2815, 0, "Ambiguous return value: Selected block modifies more than one local variable used in subsequent code. Affected variables are:  int maxinterval double[][] opoly9 int[] head int[] tail", 0, 0, 2, 2, 2, 0, 0, 0
1764, 2530, 0, "Ambiguous return value: Selected block modifies more than one local variable used in subsequent code. Affected variables are:  int maxinterval int lenp", 0, 0, 4, 4, 4, 0, 0, 0
2300, 4345, 1, "OK", 3, 58, 11, 11, 7, 4, 4, 0
2487, 2644, 1, "OK", 2, 6, 1, 1, 1, 0, 0, 0
2871, 3028, 1, "OK", 4, 4, 2, 1, 1, 0, 1, 1
1376, 2274, 1, "OK", 3, 15, 13, 13, 9, 4, 4, 0
1376, 4324, 0, "Ambiguous return value: Selected block modifies more than one local variable used in subsequent code. Affected variables are:  double[][] opoly9 int[] pind", 0, 0, 24, 24, 16, 8, 8, 0
1893, 4682, 1, "OK", 5, 77, 15, 15, 11, 4, 4, 0
1050, 2145, 0, "Ambiguous return value: Selected block modifies more than one local variable used in subsequent code. Affected variables are:  double[][] p double[][] rx9 double[][] ry9", 0, 0, 12, 12, 8, 4, 4, 0
970, 4626, 0, "Ambiguous return value: Selected block modifies more than one local variable used in subsequent code. Affected variables are:  List<Double> lower List<Double> upper", 0, 0, 25, 25, 17, 8, 8, 0
1893, 2644, 0, "Ambiguous return value: Selected block modifies more than one local variable used in subsequent code. Affected variables are:  int maxinterval int lenp", 0, 0, 4, 4, 4, 0, 0, 0
1018, 3147, 0, "Ambiguous return value: Selected block modifies more than one local variable used in subsequent code. Affected variables are:  double[][] p double[][] opoly9 int[] head int[] tail int[] v4", 0, 0, 17, 17, 12, 5, 5, 0
2696, 4377, 1, "OK", 4, 47, 10, 10, 6, 4, 4, 0
2824, 4505, 0, "Ambiguous return value: Selected block modifies more than one local variable used in subsequent code. Affected variables are:  List<Double> lower List<Double> upper", 0, 0, 10, 10, 6, 4, 4, 0
2536, 3195, 0, "Ambiguous return value: Selected block modifies more than one local variable used in subsequent code. Affected variables are:  double[][] opoly9 int[] head int[] tail int[] v4", 0, 0, 4, 4, 3, 1, 1, 0
1376, 2294, 1, "OK", 3, 16, 13, 13, 9, 4, 4, 0
1319, 2016, 0, "Ambiguous return value: Selected block modifies more than one local variable used in subsequent code. Affected variables are:  double[][] rx9 double[][] ry9", 0, 0, 11, 11, 7, 4, 4, 0
1376, 4345, 1, "OK", 3, 74, 24, 24, 16, 8, 8, 0
1433, 4626, 0, "Ambiguous return value: Selected block modifies more than one local variable used in subsequent code. Affected variables are:  List<Double> lower List<Double> upper", 0, 0, 25, 25, 17, 8, 8, 0
2022, 2751, 0, "Ambiguous return value: Selected block modifies more than one local variable used in subsequent code. Affected variables are:  int maxinterval double[][] opoly9 int[] head", 0, 0, 3, 3, 3, 0, 0, 0
1018, 3160, 0, "Ambiguous return value: Selected block modifies more than one local variable used in subsequent code. Affected variables are:  double[][] p double[][] opoly9 int[] head int[] tail int[] v4", 0, 0, 17, 17, 12, 5, 5, 0
2300, 4377, 1, "OK", 3, 59, 11, 11, 7, 4, 4, 0
2362, 4505, 0, "Ambiguous return value: Selected block modifies more than one local variable used in subsequent code. Affected variables are:  List<Double> lower List<Double> upper", 0, 0, 11, 11, 7, 4, 4, 0
970, 2605, 0, "Ambiguous return value: Selected block modifies more than one local variable used in subsequent code. Affected variables are:  double[][] p int maxinterval int lenp", 0, 0, 14, 14, 10, 4, 4, 0
970, 4655, 1, "OK", 2, 97, 25, 25, 17, 8, 8, 0
3567, 4023, 0, "Ambiguous return value: Selected block modifies more than one local variable used in subsequent code. Affected variables are:  double[] interp int ic", 0, 0, 4, 2, 2, 0, 2, 1
1217, 3147, 0, "Ambiguous return value: Selected block modifies more than one local variable used in subsequent code. Affected variables are:  double[][] p double[][] opoly9 int[] head int[] tail int[] v4", 0, 0, 17, 17, 12, 5, 5, 0
1376, 2314, 1, "OK", 3, 17, 13, 13, 9, 4, 4, 0
2487, 2690, 1, "OK", 2, 7, 1, 1, 1, 0, 0, 0
2417, 2815, 0, "Ambiguous return value: Selected block modifies more than one local variable used in subsequent code. Affected variables are:  int maxinterval double[][] opoly9 int[] head int[] tail", 0, 0, 1, 1, 1, 0, 0, 0
1764, 4626, 0, "Ambiguous return value: Selected block modifies more than one local variable used in subsequent code. Affected variables are:  List<Double> lower List<Double> upper", 0, 0, 16, 16, 12, 4, 4, 0
1433, 2605, 0, "Ambiguous return value: Selected block modifies more than one local variable used in subsequent code. Affected variables are:  int maxinterval int lenp", 0, 0, 14, 14, 10, 4, 4, 0
2536, 3230, 0, "Ambiguous return value: Selected block modifies more than one local variable used in subsequent code. Affected variables are:  double[][] opoly9 int[] head int[] tail int[] v4", 0, 0, 4, 4, 3, 1, 1, 0
1433, 4655, 1, "OK", 5, 84, 25, 25, 17, 8, 8, 0
1217, 3160, 0, "Ambiguous return value: Selected block modifies more than one local variable used in subsequent code. Affected variables are:  double[][] p double[][] opoly9 int[] head int[] tail int[] v4", 0, 0, 17, 17, 12, 5, 5, 0
1376, 4377, 1, "OK", 3, 75, 24, 24, 16, 8, 8, 0
1893, 2690, 0, "Ambiguous return value: Selected block modifies more than one local variable used in subsequent code. Affected variables are:  int maxinterval double[][] opoly9", 0, 0, 4, 4, 4, 0, 0, 0
970, 4682, 1, "OK", 2, 98, 25, 25, 17, 8, 8, 0
1018, 3195, 0, "Ambiguous return value: Selected block modifies more than one local variable used in subsequent code. Affected variables are:  double[][] p double[][] opoly9 int[] head int[] tail int[] v4", 0, 0, 17, 17, 12, 5, 5, 0
1764, 2605, 0, "Ambiguous return value: Selected block modifies more than one local variable used in subsequent code. Affected variables are:  int maxinterval int lenp", 0, 0, 5, 5, 5, 0, 0, 0
970, 2644, 0, "Ambiguous return value: Selected block modifies more than one local variable used in subsequent code. Affected variables are:  double[][] p int maxinterval int lenp", 0, 0, 14, 14, 10, 4, 4, 0
1764, 4655, 1, "OK", 5, 78, 16, 16, 12, 4, 4, 0
1050, 4267, 0, "Ambiguous return value: Selected block modifies more than one local variable used in subsequent code. Affected variables are:  double[][] opoly9 int[] pind int ic", 0, 0, 24, 24, 16, 8, 8, 0
1433, 4682, 1, "OK", 5, 85, 25, 25, 17, 8, 8, 0
2760, 4505, 0, "Ambiguous return value: Selected block modifies more than one local variable used in subsequent code. Affected variables are:  List<Double> lower List<Double> upper", 0, 0, 10, 10, 6, 4, 4, 0
1376, 2356, 1, "OK", 3, 18, 13, 13, 9, 4, 4, 0
1217, 3195, 0, "Ambiguous return value: Selected block modifies more than one local variable used in subsequent code. Affected variables are:  double[][] p double[][] opoly9 int[] head int[] tail int[] v4", 0, 0, 17, 17, 12, 5, 5, 0
2022, 2815, 0, "Ambiguous return value: Selected block modifies more than one local variable used in subsequent code. Affected variables are:  int maxinterval double[][] opoly9 int[] head int[] tail", 0, 0, 3, 3, 3, 0, 0, 0
1433, 2644, 0, "Ambiguous return value: Selected block modifies more than one local variable used in subsequent code. Affected variables are:  int maxinterval int lenp", 0, 0, 14, 14, 10, 4, 4, 0
2536, 3268, 0, "Ambiguous return value: Selected block modifies more than one local variable used in subsequent code. Affected variables are:  double[][] opoly9 int[] head int[] tail int[] v4", 0, 0, 4, 4, 3, 1, 1, 0
3153, 4626, 0, "Ambiguous return value: Selected block modifies more than one local variable used in subsequent code. Affected variables are:  List<Double> lower List<Double> upper", 0, 0, 8, 8, 5, 3, 3, 0
1018, 3230, 0, "Ambiguous return value: Selected block modifies more than one local variable used in subsequent code. Affected variables are:  double[][] p double[][] opoly9 int[] head int[] tail int[] v4", 0, 0, 17, 17, 12, 5, 5, 0
1764, 4682, 1, "OK", 5, 79, 16, 16, 12, 4, 4, 0
2487, 2751, 0, "Ambiguous return value: Selected block modifies more than one local variable used in subsequent code. Affected variables are:  double[][] opoly9 int[] head", 0, 0, 1, 1, 1, 0, 0, 0
1376, 2379, 1, "OK", 3, 19, 13, 13, 9, 4, 4, 0
1198, 1758, 0, "Ambiguous return value: Selected block modifies more than one local variable used in subsequent code. Affected variables are:  double[][] p double[][] rx9 double[][] ry9", 0, 0, 9, 9, 5, 4, 4, 0
1764, 2644, 0, "Ambiguous return value: Selected block modifies more than one local variable used in subsequent code. Affected variables are:  int maxinterval int lenp", 0, 0, 5, 5, 5, 0, 0, 0
2280, 3035, 0, "Ambiguous return value: Selected block modifies more than one local variable used in subsequent code. Affected variables are:  double[][] opoly9 int[] head int[] tail", 0, 0, 4, 4, 3, 1, 1, 0
970, 2690, 0, "Ambiguous return value: Selected block modifies more than one local variable used in subsequent code. Affected variables are:  double[][] p int maxinterval double[][] opoly9", 0, 0, 14, 14, 10, 4, 4, 0
1893, 2751, 0, "Ambiguous return value: Selected block modifies more than one local variable used in subsequent code. Affected variables are:  int maxinterval double[][] opoly9 int[] head", 0, 0, 4, 4, 4, 0, 0, 0
1217, 3230, 0, "Ambiguous return value: Selected block modifies more than one local variable used in subsequent code. Affected variables are:  double[][] p double[][] opoly9 int[] head int[] tail int[] v4", 0, 0, 17, 17, 12, 5, 5, 0
3153, 4655, 1, "OK", 7, 47, 8, 8, 5, 3, 3, 0
3515, 3673, 1, "OK", 4, 5, 2, 1, 1, 0, 1, 1
2536, 3312, 0, "Ambiguous return value: Selected block modifies more than one local variable used in subsequent code. Affected variables are:  double[][] opoly9 int[] head int[] tail int[] v4 int[] pind", 0, 0, 4, 4, 3, 1, 1, 0
2611, 3035, 0, "Ambiguous return value: Selected block modifies more than one local variable used in subsequent code. Affected variables are:  double[][] opoly9 int[] head int[] tail", 0, 0, 3, 3, 2, 1, 1, 0
1050, 2274, 0, "Ambiguous return value: Selected block modifies more than one local variable used in subsequent code. Affected variables are:  double[][] p double[][] rx9 double[][] ry9", 0, 0, 13, 13, 9, 4, 4, 0
1433, 2690, 0, "Ambiguous return value: Selected block modifies more than one local variable used in subsequent code. Affected variables are:  int maxinterval double[][] opoly9", 0, 0, 14, 14, 10, 4, 4, 0
2824, 4626, 0, "Ambiguous return value: Selected block modifies more than one local variable used in subsequent code. Affected variables are:  List<Double> lower List<Double> upper", 0, 0, 11, 11, 7, 4, 4, 0
1018, 3268, 0, "Ambiguous return value: Selected block modifies more than one local variable used in subsequent code. Affected variables are:  double[][] p double[][] opoly9 int[] head int[] tail int[] v4", 0, 0, 17, 17, 12, 5, 5, 0
1050, 4324, 0, "Ambiguous return value: Selected block modifies more than one local variable used in subsequent code. Affected variables are:  double[][] opoly9 int[] pind", 0, 0, 24, 24, 16, 8, 8, 0
3166, 4267, 0, "Ambiguous return value: Selected block modifies more than one local variable used in subsequent code. Affected variables are:  int[] pind int ic", 0, 0, 7, 7, 4, 3, 3, 0
2696, 4505, 0, "Ambiguous return value: Selected block modifies more than one local variable used in subsequent code. Affected variables are:  List<Double> lower List<Double> upper", 0, 0, 10, 10, 6, 4, 4, 0
2362, 4626, 0, "Ambiguous return value: Selected block modifies more than one local variable used in subsequent code. Affected variables are:  List<Double> lower List<Double> upper", 0, 0, 12, 12, 8, 4, 4, 0
1319, 2145, 0, "Ambiguous return value: Selected block modifies more than one local variable used in subsequent code. Affected variables are:  double[][] rx9 double[][] ry9", 0, 0, 12, 12, 8, 4, 4, 0
2536, 3329, 0, "Ambiguous return value: Selected block modifies more than one local variable used in subsequent code. Affected variables are:  double[][] opoly9 int[] head int[] tail int[] v4 int[] pind int ic", 0, 0, 4, 4, 3, 1, 1, 0
3153, 4682, 1, "OK", 7, 48, 8, 8, 5, 3, 3, 0
1050, 2294, 0, "Ambiguous return value: Selected block modifies more than one local variable used in subsequent code. Affected variables are:  double[][] p double[][] ry9", 0, 0, 13, 13, 9, 4, 4, 0
1764, 2690, 0, "Ambiguous return value: Selected block modifies more than one local variable used in subsequent code. Affected variables are:  int maxinterval double[][] opoly9", 0, 0, 5, 5, 5, 0, 0, 0
2300, 4505, 0, "Ambiguous return value: Selected block modifies more than one local variable used in subsequent code. Affected variables are:  List<Double> lower List<Double> upper", 0, 0, 11, 11, 7, 4, 4, 0
1050, 4345, 1, "OK", 1, 84, 24, 24, 16, 8, 8, 0
1217, 3268, 0, "Ambiguous return value: Selected block modifies more than one local variable used in subsequent code. Affected variables are:  double[][] p double[][] opoly9 int[] head int[] tail int[] v4", 0, 0, 17, 17, 12, 5, 5, 0
2487, 2815, 0, "Ambiguous return value: Selected block modifies more than one local variable used in subsequent code. Affected variables are:  double[][] opoly9 int[] head int[] tail", 0, 0, 1, 1, 1, 0, 0, 0
2824, 4655, 1, "OK", 7, 55, 11, 11, 7, 4, 4, 0
1050, 2314, 1, "OK", 1, 27, 13, 13, 9, 4, 4, 0
2362, 2605, 0, "Ambiguous return value: Selected block modifies more than one local variable used in subsequent code. Affected variables are:  int maxinterval int lenp", 0, 0, 1, 1, 1, 0, 0, 0
970, 2751, 0, "Ambiguous return value: Selected block modifies more than one local variable used in subsequent code. Affected variables are:  double[][] p int maxinterval double[][] opoly9 int[] head", 0, 0, 14, 14, 10, 4, 4, 0
1018, 3312, 0, "Ambiguous return value: Selected block modifies more than one local variable used in subsequent code. Affected variables are:  double[][] p double[][] opoly9 int[] head int[] tail int[] v4 int[] pind", 0, 0, 17, 17, 12, 5, 5, 0
2362, 4655, 1, "OK", 4, 67, 12, 12, 8, 4, 4, 0
1376, 4505, 0, "Ambiguous return value: Selected block modifies more than one local variable used in subsequent code. Affected variables are:  List<Double> lower List<Double> upper", 0, 0, 24, 24, 16, 8, 8, 0
1893, 2815, 0, "Ambiguous return value: Selected block modifies more than one local variable used in subsequent code. Affected variables are:  int maxinterval double[][] opoly9 int[] head int[] tail", 0, 0, 4, 4, 4, 0, 0, 0
1050, 4377, 1, "OK", 1, 85, 24, 24, 16, 8, 8, 0
2824, 4682, 1, "OK", 7, 56, 11, 11, 7, 4, 4, 0
3166, 4324, 1, "OK", 6, 34, 7, 7, 4, 3, 3, 0
3515, 3745, 1, "OK", 5, 8, 2, 1, 1, 0, 1, 1
1433, 2751, 0, "Ambiguous return value: Selected block modifies more than one local variable used in subsequent code. Affected variables are:  int maxinterval double[][] opoly9 int[] head", 0, 0, 14, 14, 10, 4, 4, 0
1018, 3329, 0, "Ambiguous return value: Selected block modifies more than one local variable used in subsequent code. Affected variables are:  double[][] p double[][] opoly9 int[] head int[] tail int[] v4 int[] pind int ic", 0, 0, 17, 17, 12, 5, 5, 0
2760, 4626, 0, "Ambiguous return value: Selected block modifies more than one local variable used in subsequent code. Affected variables are:  List<Double> lower List<Double> upper", 0, 0, 11, 11, 7, 4, 4, 0
1217, 3312, 0, "Ambiguous return value: Selected block modifies more than one local variable used in subsequent code. Affected variables are:  double[][] p double[][] opoly9 int[] head int[] tail int[] v4 int[] pind", 0, 0, 17, 17, 12, 5, 5, 0
2362, 4682, 1, "OK", 4, 68, 12, 12, 8, 4, 4, 0
1376, 2481, 1, "OK", 3, 21, 13, 13, 9, 4, 4, 0
2151, 3035, 0, "Ambiguous return value: Selected block modifies more than one local variable used in subsequent code. Affected variables are:  double[][] opoly9 int[] head int[] tail", 0, 0, 5, 5, 4, 1, 1, 0
2362, 2644, 0, "Ambiguous return value: Selected block modifies more than one local variable used in subsequent code. Affected variables are:  int maxinterval int lenp", 0, 0, 1, 1, 1, 0, 0, 0
1050, 2356, 0, "Ambiguous return value: Selected block modifies more than one local variable used in subsequent code. Affected variables are:  double[][] p double[][] c9", 0, 0, 13, 13, 9, 4, 4, 0
1764, 2751, 0, "Ambiguous return value: Selected block modifies more than one local variable used in subsequent code. Affected variables are:  int maxinterval double[][] opoly9 int[] head", 0, 0, 5, 5, 5, 0, 0, 0
3166, 4345, 1, "OK", 6, 35, 7, 7, 4, 3, 3, 0
1217, 3329, 0, "Ambiguous return value: Selected block modifies more than one local variable used in subsequent code. Affected variables are:  double[][] p double[][] opoly9 int[] head int[] tail int[] v4 int[] pind int ic", 0, 0, 17, 17, 12, 5, 5, 0
1319, 4267, 0, "Ambiguous return value: Selected block modifies more than one local variable used in subsequent code. Affected variables are:  double[][] opoly9 int[] pind int ic", 0, 0, 24, 24, 16, 8, 8, 0
2280, 3147, 0, "Ambiguous return value: Selected block modifies more than one local variable used in subsequent code. Affected variables are:  double[][] opoly9 int[] head int[] tail int[] v4", 0, 0, 4, 4, 3, 1, 1, 0
2760, 4655, 1, "OK", 6, 56, 11, 11, 7, 4, 4, 0
1376, 2511, 1, "OK", 3, 22, 13, 13, 9, 4, 4, 0
2280, 3160, 0, "Ambiguous return value: Selected block modifies more than one local variable used in subsequent code. Affected variables are:  double[][] opoly9 int[] head int[] tail int[] v4", 0, 0, 4, 4, 3, 1, 1, 0
1050, 2379, 1, "OK", 1, 29, 13, 13, 9, 4, 4, 0
1198, 1887, 0, "Ambiguous return value: Selected block modifies more than one local variable used in subsequent code. Affected variables are:  double[][] p double[][] rx9 double[][] ry9", 0, 0, 10, 10, 6, 4, 4, 0
970, 2815, 0, "Ambiguous return value: Selected block modifies more than one local variable used in subsequent code. Affected variables are:  double[][] p int maxinterval double[][] opoly9 int[] head int[] tail", 0, 0, 14, 14, 10, 4, 4, 0
3515, 3792, 0, "Ambiguous return value: Selected block modifies more than one local variable used in subsequent code. Affected variables are:  double[] kb1 double[] kb2", 0, 0, 2, 1, 1, 0, 1, 1
2611, 3147, 0, "Ambiguous return value: Selected block modifies more than one local variable used in subsequent code. Affected variables are:  double[][] opoly9 int[] head int[] tail int[] v4", 0, 0, 3, 3, 2, 1, 1, 0
3166, 4377, 1, "OK", 6, 36, 7, 7, 4, 3, 3, 0
3706, 4023, 0, "Ambiguous return value: Selected block modifies more than one local variable used in subsequent code. Affected variables are:  double[] interp int ic", 0, 0, 2, 1, 1, 0, 1, 1
2760, 4682, 1, "OK", 6, 57, 11, 11, 7, 4, 4, 0
1376, 2530, 0, "Ambiguous return value: Selected block modifies more than one local variable used in subsequent code. Affected variables are:  int maxinterval int lenp", 0, 0, 13, 13, 9, 4, 4, 0
1433, 2815, 0, "Ambiguous return value: Selected block modifies more than one local variable used in subsequent code. Affected variables are:  int maxinterval double[][] opoly9 int[] head int[] tail", 0, 0, 14, 14, 10, 4, 4, 0
2611, 3160, 0, "Ambiguous return value: Selected block modifies more than one local variable used in subsequent code. Affected variables are:  double[][] opoly9 int[] head int[] tail int[] v4", 0, 0, 3, 3, 2, 1, 1, 0
2362, 2690, 0, "Ambiguous return value: Selected block modifies more than one local variable used in subsequent code. Affected variables are:  int maxinterval double[][] opoly9", 0, 0, 1, 1, 1, 0, 0, 0
3236, 4267, 0, "Ambiguous return value: Selected block modifies more than one local variable used in subsequent code. Affected variables are:  int[] pind int ic", 0, 0, 7, 7, 4, 3, 3, 0
2417, 3035, 0, "Ambiguous return value: Selected block modifies more than one local variable used in subsequent code. Affected variables are:  double[][] opoly9 int[] head int[] tail", 0, 0, 4, 4, 3, 1, 1, 0
2696, 4626, 0, "Ambiguous return value: Selected block modifies more than one local variable used in subsequent code. Affected variables are:  List<Double> lower List<Double> upper", 0, 0, 11, 11, 7, 4, 4, 0
2280, 3195, 0, "Ambiguous return value: Selected block modifies more than one local variable used in subsequent code. Affected variables are:  double[][] opoly9 int[] head int[] tail int[] v4", 0, 0, 4, 4, 3, 1, 1, 0
2300, 4626, 0, "Ambiguous return value: Selected block modifies more than one local variable used in subsequent code. Affected variables are:  List<Double> lower List<Double> upper", 0, 0, 12, 12, 8, 4, 4, 0
3567, 4260, 1, "OK", 8, 20, 6, 3, 3, 0, 3, 1
1319, 2274, 0, "Ambiguous return value: Selected block modifies more than one local variable used in subsequent code. Affected variables are:  double[][] rx9 double[][] ry9", 0, 0, 13, 13, 9, 4, 4, 0
1764, 2815, 0, "Ambiguous return value: Selected block modifies more than one local variable used in subsequent code. Affected variables are:  int maxinterval double[][] opoly9 int[] head int[] tail", 0, 0, 5, 5, 5, 0, 0, 0
1319, 4324, 0, "Ambiguous return value: Selected block modifies more than one local variable used in subsequent code. Affected variables are:  double[][] opoly9 int[] pind", 0, 0, 24, 24, 16, 8, 8, 0
3515, 3832, 1, "OK", 5, 10, 2, 1, 1, 0, 1, 1
2611, 3195, 0, "Ambiguous return value: Selected block modifies more than one local variable used in subsequent code. Affected variables are:  double[][] opoly9 int[] head int[] tail int[] v4", 0, 0, 3, 3, 2, 1, 1, 0
2696, 4655, 1, "OK", 5, 57, 11, 11, 7, 4, 4, 0
1319, 2294, 1, "OK", 2, 17, 13, 13, 9, 4, 4, 0
940, 1758, 0, "Ambiguous return value: Selected block modifies more than one local variable used in subsequent code. Affected variables are:  double[][] p double[][] rx9 double[][] ry9", 0, 0, 9, 9, 5, 4, 4, 0
1319, 4345, 1, "OK", 2, 75, 24, 24, 16, 8, 8, 0
1376, 4626, 0, "Ambiguous return value: Selected block modifies more than one local variable used in subsequent code. Affected variables are:  List<Double> lower List<Double> upper", 0, 0, 25, 25, 17, 8, 8, 0
2300, 2605, 0, "Ambiguous return value: Selected block modifies more than one local variable used in subsequent code. Affected variables are:  int maxinterval int lenp", 0, 0, 1, 1, 1, 0, 0, 0
2300, 4655, 1, "OK", 4, 69, 12, 12, 8, 4, 4, 0
2280, 3230, 0, "Ambiguous return value: Selected block modifies more than one local variable used in subsequent code. Affected variables are:  double[][] opoly9 int[] head int[] tail int[] v4", 0, 0, 4, 4, 3, 1, 1, 0
2022, 3035, 0, "Ambiguous return value: Selected block modifies more than one local variable used in subsequent code. Affected variables are:  double[][] opoly9 int[] head int[] tail", 0, 0, 6, 6, 5, 1, 1, 0
1050, 4505, 0, "Ambiguous return value: Selected block modifies more than one local variable used in subsequent code. Affected variables are:  List<Double> lower List<Double> upper", 0, 0, 24, 24, 16, 8, 8, 0
3236, 4324, 1, "OK", 6, 32, 7, 7, 4, 3, 3, 0
2696, 4682, 1, "OK", 5, 58, 11, 11, 7, 4, 4, 0
1319, 2314, 1, "OK", 2, 18, 13, 13, 9, 4, 4, 0
2151, 3147, 0, "Ambiguous return value: Selected block modifies more than one local variable used in subsequent code. Affected variables are:  double[][] opoly9 int[] head int[] tail int[] v4", 0, 0, 5, 5, 4, 1, 1, 0
2362, 2751, 0, "Ambiguous return value: Selected block modifies more than one local variable used in subsequent code. Affected variables are:  int maxinterval double[][] opoly9 int[] head", 0, 0, 1, 1, 1, 0, 0, 0
4031, 4260, 1, "OK", 8, 6, 2, 1, 1, 0, 1, 1
2611, 3230, 0, "Ambiguous return value: Selected block modifies more than one local variable used in subsequent code. Affected variables are:  double[][] opoly9 int[] head int[] tail int[] v4", 0, 0, 3, 3, 2, 1, 1, 0
1073, 1758, 0, "Ambiguous return value: Selected block modifies more than one local variable used in subsequent code. Affected variables are:  double[][] p double[][] rx9 double[][] ry9", 0, 0, 9, 9, 5, 4, 4, 0
1376, 2605, 0, "Ambiguous return value: Selected block modifies more than one local variable used in subsequent code. Affected variables are:  int maxinterval int lenp", 0, 0, 14, 14, 10, 4, 4, 0
2300, 4682, 1, "OK", 4, 70, 12, 12, 8, 4, 4, 0
1376, 4655, 1, "OK", 4, 85, 25, 25, 17, 8, 8, 0
1319, 4377, 1, "OK", 2, 76, 24, 24, 16, 8, 8, 0
2151, 3160, 0, "Ambiguous return value: Selected block modifies more than one local variable used in subsequent code. Affected variables are:  double[][] opoly9 int[] head int[] tail int[] v4", 0, 0, 5, 5, 4, 1, 1, 0
3236, 4345, 1, "OK", 6, 33, 7, 7, 4, 3, 3, 0
1050, 2481, 0, "Ambiguous return value: Selected block modifies more than one local variable used in subsequent code. Affected variables are:  double[][] p int maxinterval", 0, 0, 13, 13, 9, 4, 4, 0
2300, 2644, 0, "Ambiguous return value: Selected block modifies more than one local variable used in subsequent code. Affected variables are:  int maxinterval int lenp", 0, 0, 1, 1, 1, 0, 0, 0
2280, 3268, 0, "Ambiguous return value: Selected block modifies more than one local variable used in subsequent code. Affected variables are:  double[][] opoly9 int[] head int[] tail int[] v4", 0, 0, 4, 4, 3, 1, 1, 0
1376, 4682, 1, "OK", 4, 86, 25, 25, 17, 8, 8, 0
1319, 2356, 1, "OK", 2, 19, 13, 13, 9, 4, 4, 0
1198, 2016, 0, "Ambiguous return value: Selected block modifies more than one local variable used in subsequent code. Affected variables are:  double[][] p double[][] rx9 double[][] ry9", 0, 0, 11, 11, 7, 4, 4, 0
2611, 3268, 0, "Ambiguous return value: Selected block modifies more than one local variable used in subsequent code. Affected variables are:  double[][] opoly9 int[] head int[] tail int[] v4", 0, 0, 3, 3, 2, 1, 1, 0
2151, 3195, 0, "Ambiguous return value: Selected block modifies more than one local variable used in subsequent code. Affected variables are:  double[][] opoly9 int[] head int[] tail int[] v4", 0, 0, 5, 5, 4, 1, 1, 0
1376, 2644, 0, "Ambiguous return value: Selected block modifies more than one local variable used in subsequent code. Affected variables are:  int maxinterval int lenp", 0, 0, 14, 14, 10, 4, 4, 0
1050, 2511, 0, "Ambiguous return value: Selected block modifies more than one local variable used in subsequent code. Affected variables are:  double[][] p int maxinterval", 0, 0, 13, 13, 9, 4, 4, 0
4351, 4626, 0, "Ambiguous return value: Selected block modifies more than one local variable used in subsequent code. Affected variables are:  List<Double> lower List<Double> upper", 0, 0, 1, 1, 1, 0, 0, 0
3236, 4377, 1, "OK", 6, 34, 7, 7, 4, 3, 3, 0
2417, 3147, 0, "Ambiguous return value: Selected block modifies more than one local variable used in subsequent code. Affected variables are:  double[][] opoly9 int[] head int[] tail int[] v4", 0, 0, 4, 4, 3, 1, 1, 0
3166, 4505, 0, "Ambiguous return value: Selected block modifies more than one local variable used in subsequent code. Affected variables are:  List<Double> lower List<Double> upper", 0, 0, 7, 7, 4, 3, 3, 0
2487, 3035, 0, "Ambiguous return value: Selected block modifies more than one local variable used in subsequent code. Affected variables are:  double[][] opoly9 int[] head int[] tail", 0, 0, 4, 4, 3, 1, 1, 0
1319, 2379, 1, "OK", 2, 20, 13, 13, 9, 4, 4, 0
2300, 2690, 0, "Ambiguous return value: Selected block modifies more than one local variable used in subsequent code. Affected variables are:  int maxinterval double[][] opoly9", 0, 0, 1, 1, 1, 0, 0, 0
2362, 2815, 0, "Ambiguous return value: Selected block modifies more than one local variable used in subsequent code. Affected variables are:  int maxinterval double[][] opoly9 int[] head int[] tail", 0, 0, 1, 1, 1, 0, 0, 0
2280, 3312, 0, "Ambiguous return value: Selected block modifies more than one local variable used in subsequent code. Affected variables are:  double[][] opoly9 int[] head int[] tail int[] v4 int[] pind", 0, 0, 4, 4, 3, 1, 1, 0
1050, 2530, 0, "Ambiguous return value: Selected block modifies more than one local variable used in subsequent code. Affected variables are:  double[][] p int maxinterval int lenp", 0, 0, 13, 13, 9, 4, 4, 0
2417, 3160, 0, "Ambiguous return value: Selected block modifies more than one local variable used in subsequent code. Affected variables are:  double[][] opoly9 int[] head int[] tail int[] v4", 0, 0, 4, 4, 3, 1, 1, 0
4351, 4655, 1, "OK", 2, 11, 1, 1, 1, 0, 0, 0
1893, 3035, 0, "Ambiguous return value: Selected block modifies more than one local variable used in subsequent code. Affected variables are:  double[][] opoly9 int[] head int[] tail", 0, 0, 7, 7, 6, 1, 1, 0
2151, 3230, 0, "Ambiguous return value: Selected block modifies more than one local variable used in subsequent code. Affected variables are:  double[][] opoly9 int[] head int[] tail int[] v4", 0, 0, 5, 5, 4, 1, 1, 0
2280, 3329, 0, "Ambiguous return value: Selected block modifies more than one local variable used in subsequent code. Affected variables are:  double[][] opoly9 int[] head int[] tail int[] v4 int[] pind int ic", 0, 0, 4, 4, 3, 1, 1, 0
2611, 3312, 0, "Ambiguous return value: Selected block modifies more than one local variable used in subsequent code. Affected variables are:  double[][] opoly9 int[] head int[] tail int[] v4 int[] pind", 0, 0, 3, 3, 2, 1, 1, 0
1376, 2690, 0, "Ambiguous return value: Selected block modifies more than one local variable used in subsequent code. Affected variables are:  int maxinterval double[][] opoly9", 0, 0, 14, 14, 10, 4, 4, 0
2022, 3147, 0, "Ambiguous return value: Selected block modifies more than one local variable used in subsequent code. Affected variables are:  double[][] opoly9 int[] head int[] tail int[] v4", 0, 0, 6, 6, 5, 1, 1, 0
2417, 3195, 0, "Ambiguous return value: Selected block modifies more than one local variable used in subsequent code. Affected variables are:  double[][] opoly9 int[] head int[] tail int[] v4", 0, 0, 4, 4, 3, 1, 1, 0
2611, 3329, 0, "Ambiguous return value: Selected block modifies more than one local variable used in subsequent code. Affected variables are:  double[][] opoly9 int[] head int[] tail int[] v4 int[] pind int ic", 0, 0, 3, 3, 2, 1, 1, 0
4351, 4682, 1, "OK", 2, 12, 1, 1, 1, 0, 0, 0
2022, 3160, 0, "Ambiguous return value: Selected block modifies more than one local variable used in subsequent code. Affected variables are:  double[][] opoly9 int[] head int[] tail int[] v4", 0, 0, 6, 6, 5, 1, 1, 0
940, 1887, 0, "Ambiguous return value: Selected block modifies more than one local variable used in subsequent code. Affected variables are:  double[][] p double[][] rx9 double[][] ry9", 0, 0, 10, 10, 6, 4, 4, 0
1050, 4626, 0, "Ambiguous return value: Selected block modifies more than one local variable used in subsequent code. Affected variables are:  List<Double> lower List<Double> upper", 0, 0, 25, 25, 17, 8, 8, 0
2151, 3268, 0, "Ambiguous return value: Selected block modifies more than one local variable used in subsequent code. Affected variables are:  double[][] opoly9 int[] head int[] tail int[] v4", 0, 0, 5, 5, 4, 1, 1, 0
1275, 1758, 0, "Ambiguous return value: Selected block modifies more than one local variable used in subsequent code. Affected variables are:  double[][] rx9 double[][] ry9", 0, 0, 9, 9, 5, 4, 4, 0
2300, 2751, 0, "Ambiguous return value: Selected block modifies more than one local variable used in subsequent code. Affected variables are:  int maxinterval double[][] opoly9 int[] head", 0, 0, 1, 1, 1, 0, 0, 0
1073, 1887, 0, "Ambiguous return value: Selected block modifies more than one local variable used in subsequent code. Affected variables are:  double[][] p double[][] rx9 double[][] ry9", 0, 0, 10, 10, 6, 4, 4, 0
2417, 3230, 0, "Ambiguous return value: Selected block modifies more than one local variable used in subsequent code. Affected variables are:  double[][] opoly9 int[] head int[] tail int[] v4", 0, 0, 4, 4, 3, 1, 1, 0
970, 3035, 0, "Ambiguous return value: Selected block modifies more than one local variable used in subsequent code. Affected variables are:  double[][] p double[][] opoly9 int[] head int[] tail", 0, 0, 17, 17, 12, 5, 5, 0
1319, 4505, 0, "Ambiguous return value: Selected block modifies more than one local variable used in subsequent code. Affected variables are:  List<Double> lower List<Double> upper", 0, 0, 24, 24, 16, 8, 8, 0
1050, 2605, 0, "Ambiguous return value: Selected block modifies more than one local variable used in subsequent code. Affected variables are:  double[][] p int maxinterval int lenp", 0, 0, 14, 14, 10, 4, 4, 0
1050, 4655, 1, "OK", 2, 95, 25, 25, 17, 8, 8, 0
2022, 3195, 0, "Ambiguous return value: Selected block modifies more than one local variable used in subsequent code. Affected variables are:  double[][] opoly9 int[] head int[] tail int[] v4", 0, 0, 6, 6, 5, 1, 1, 0
3515, 4023, 0, "Ambiguous return value: Selected block modifies more than one local variable used in subsequent code. Affected variables are:  double[] interp int ic", 0, 0, 4, 2, 2, 0, 2, 1
1376, 2751, 0, "Ambiguous return value: Selected block modifies more than one local variable used in subsequent code. Affected variables are:  int maxinterval double[][] opoly9 int[] head", 0, 0, 14, 14, 10, 4, 4, 0
1433, 3035, 0, "Ambiguous return value: Selected block modifies more than one local variable used in subsequent code. Affected variables are:  double[][] opoly9 int[] head int[] tail", 0, 0, 17, 17, 12, 5, 5, 0
3706, 4260, 1, "OK", 8, 15, 4, 2, 2, 0, 2, 1
1319, 2481, 1, "OK", 2, 22, 13, 13, 9, 4, 4, 0
2151, 3312, 0, "Ambiguous return value: Selected block modifies more than one local variable used in subsequent code. Affected variables are:  double[][] opoly9 int[] head int[] tail int[] v4 int[] pind", 0, 0, 5, 5, 4, 1, 1, 0
1050, 4682, 1, "OK", 2, 96, 25, 25, 17, 8, 8, 0
1198, 2145, 0, "Ambiguous return value: Selected block modifies more than one local variable used in subsequent code. Affected variables are:  double[][] p double[][] rx9 double[][] ry9", 0, 0, 12, 12, 8, 4, 4, 0
2487, 3147, 0, "Ambiguous return value: Selected block modifies more than one local variable used in subsequent code. Affected variables are:  double[][] opoly9 int[] head int[] tail int[] v4", 0, 0, 4, 4, 3, 1, 1, 0
3166, 4626, 0, "Ambiguous return value: Selected block modifies more than one local variable used in subsequent code. Affected variables are:  List<Double> lower List<Double> upper", 0, 0, 8, 8, 5, 3, 3, 0
2417, 3268, 0, "Ambiguous return value: Selected block modifies more than one local variable used in subsequent code. Affected variables are:  double[][] opoly9 int[] head int[] tail int[] v4", 0, 0, 4, 4, 3, 1, 1, 0
2517, 4267, 0, "Ambiguous return value: Selected block modifies more than one local variable used in subsequent code. Affected variables are:  double[][] opoly9 int[] pind int ic", 0, 0, 11, 11, 7, 4, 4, 0
3236, 4505, 0, "Ambiguous return value: Selected block modifies more than one local variable used in subsequent code. Affected variables are:  List<Double> lower List<Double> upper", 0, 0, 7, 7, 4, 3, 3, 0
1764, 3035, 0, "Ambiguous return value: Selected block modifies more than one local variable used in subsequent code. Affected variables are:  double[][] opoly9 int[] head int[] tail", 0, 0, 8, 8, 7, 1, 1, 0
2022, 3230, 0, "Ambiguous return value: Selected block modifies more than one local variable used in subsequent code. Affected variables are:  double[][] opoly9 int[] head int[] tail int[] v4", 0, 0, 6, 6, 5, 1, 1, 0
2151, 3329, 0, "Ambiguous return value: Selected block modifies more than one local variable used in subsequent code. Affected variables are:  double[][] opoly9 int[] head int[] tail int[] v4 int[] pind int ic", 0, 0, 5, 5, 4, 1, 1, 0
1050, 2644, 0, "Ambiguous return value: Selected block modifies more than one local variable used in subsequent code. Affected variables are:  double[][] p int maxinterval int lenp", 0, 0, 14, 14, 10, 4, 4, 0
2487, 3160, 0, "Ambiguous return value: Selected block modifies more than one local variable used in subsequent code. Affected variables are:  double[][] opoly9 int[] head int[] tail int[] v4", 0, 0, 4, 4, 3, 1, 1, 0
2300, 2815, 0, "Ambiguous return value: Selected block modifies more than one local variable used in subsequent code. Affected variables are:  int maxinterval double[][] opoly9 int[] head int[] tail", 0, 0, 1, 1, 1, 0, 0, 0
1893, 3147, 0, "Ambiguous return value: Selected block modifies more than one local variable used in subsequent code. Affected variables are:  double[][] opoly9 int[] head int[] tail int[] v4", 0, 0, 7, 7, 6, 1, 1, 0
1319, 2511, 1, "OK", 2, 23, 13, 13, 9, 4, 4, 0
2650, 4267, 0, "Ambiguous return value: Selected block modifies more than one local variable used in subsequent code. Affected variables are:  double[][] opoly9 int[] pind int ic", 0, 0, 10, 10, 6, 4, 4, 0
3166, 4655, 1, "OK", 7, 46, 8, 8, 5, 3, 3, 0
1893, 3160, 0, "Ambiguous return value: Selected block modifies more than one local variable used in subsequent code. Affected variables are:  double[][] opoly9 int[] head int[] tail int[] v4", 0, 0, 7, 7, 6, 1, 1, 0
1319, 2530, 0, "Ambiguous return value: Selected block modifies more than one local variable used in subsequent code. Affected variables are:  int maxinterval int lenp", 0, 0, 13, 13, 9, 4, 4, 0
2320, 4267, 0, "Ambiguous return value: Selected block modifies more than one local variable used in subsequent code. Affected variables are:  double[][] opoly9 int[] pind int ic", 0, 0, 11, 11, 7, 4, 4, 0
2022, 3268, 0, "Ambiguous return value: Selected block modifies more than one local variable used in subsequent code. Affected variables are:  double[][] opoly9 int[] head int[] tail int[] v4", 0, 0, 6, 6, 5, 1, 1, 0
1376, 2815, 0, "Ambiguous return value: Selected block modifies more than one local variable used in subsequent code. Affected variables are:  int maxinterval double[][] opoly9 int[] head int[] tail", 0, 0, 14, 14, 10, 4, 4, 0
2417, 3312, 0, "Ambiguous return value: Selected block modifies more than one local variable used in subsequent code. Affected variables are:  double[][] opoly9 int[] head int[] tail int[] v4 int[] pind", 0, 0, 4, 4, 3, 1, 1, 0
2487, 3195, 0, "Ambiguous return value: Selected block modifies more than one local variable used in subsequent code. Affected variables are:  double[][] opoly9 int[] head int[] tail int[] v4", 0, 0, 4, 4, 3, 1, 1, 0
1050, 2690, 0, "Ambiguous return value: Selected block modifies more than one local variable used in subsequent code. Affected variables are:  double[][] p int maxinterval double[][] opoly9", 0, 0, 14, 14, 10, 4, 4, 0
3166, 4682, 1, "OK", 7, 47, 8, 8, 5, 3, 3, 0
2417, 3329, 0, "Ambiguous return value: Selected block modifies more than one local variable used in subsequent code. Affected variables are:  double[][] opoly9 int[] head int[] tail int[] v4 int[] pind int ic", 0, 0, 4, 4, 3, 1, 1, 0
2517, 4324, 0, "Ambiguous return value: Selected block modifies more than one local variable used in subsequent code. Affected variables are:  double[][] opoly9 int[] pind", 0, 0, 11, 11, 7, 4, 4, 0
3463, 3673, 1, "OK", 5, 7, 2, 1, 1, 0, 1, 1
940, 2016, 0, "Ambiguous return value: Selected block modifies more than one local variable used in subsequent code. Affected variables are:  double[][] p double[][] rx9 double[][] ry9", 0, 0, 11, 11, 7, 4, 4, 0
1893, 3195, 0, "Ambiguous return value: Selected block modifies more than one local variable used in subsequent code. Affected variables are:  double[][] opoly9 int[] head int[] tail int[] v4", 0, 0, 7, 7, 6, 1, 1, 0
1198, 4267, 0, "Ambiguous return value: Selected block modifies more than one local variable used in subsequent code. Affected variables are:  double[][] opoly9 int[] pind int ic", 0, 0, 24, 24, 16, 8, 8, 0
970, 3147, 0, "Ambiguous return value: Selected block modifies more than one local variable used in subsequent code. Affected variables are:  double[][] p double[][] opoly9 int[] head int[] tail int[] v4", 0, 0, 17, 17, 12, 5, 5, 0
2517, 4345, 1, "OK", 3, 52, 11, 11, 7, 4, 4, 0
1275, 1887, 0, "Ambiguous return value: Selected block modifies more than one local variable used in subsequent code. Affected variables are:  double[][] rx9 double[][] ry9", 0, 0, 10, 10, 6, 4, 4, 0
2487, 3230, 0, "Ambiguous return value: Selected block modifies more than one local variable used in subsequent code. Affected variables are:  double[][] opoly9 int[] head int[] tail int[] v4", 0, 0, 4, 4, 3, 1, 1, 0
2022, 3312, 0, "Ambiguous return value: Selected block modifies more than one local variable used in subsequent code. Affected variables are:  double[][] opoly9 int[] head int[] tail int[] v4 int[] pind", 0, 0, 6, 6, 5, 1, 1, 0
2650, 4324, 0, "Ambiguous return value: Selected block modifies more than one local variable used in subsequent code. Affected variables are:  double[][] opoly9 int[] pind", 0, 0, 10, 10, 6, 4, 4, 0
1319, 4626, 0, "Ambiguous return value: Selected block modifies more than one local variable used in subsequent code. Affected variables are:  List<Double> lower List<Double> upper", 0, 0, 25, 25, 17, 8, 8, 0
970, 3160, 0, "Ambiguous return value: Selected block modifies more than one local variable used in subsequent code. Affected variables are:  double[][] p double[][] opoly9 int[] head int[] tail int[] v4", 0, 0, 17, 17, 12, 5, 5, 0
1073, 2016, 0, "Ambiguous return value: Selected block modifies more than one local variable used in subsequent code. Affected variables are:  double[][] p double[][] rx9 double[][] ry9", 0, 0, 11, 11, 7, 4, 4, 0
1433, 3147, 0, "Ambiguous return value: Selected block modifies more than one local variable used in subsequent code. Affected variables are:  double[][] opoly9 int[] head int[] tail int[] v4", 0, 0, 17, 17, 12, 5, 5, 0
2320, 4324, 0, "Ambiguous return value: Selected block modifies more than one local variable used in subsequent code. Affected variables are:  double[][] opoly9 int[] pind", 0, 0, 11, 11, 7, 4, 4, 0
2824, 3035, 1, "OK", 4, 6, 3, 3, 2, 1, 1, 0
1893, 3230, 0, "Ambiguous return value: Selected block modifies more than one local variable used in subsequent code. Affected variables are:  double[][] opoly9 int[] head int[] tail int[] v4", 0, 0, 7, 7, 6, 1, 1, 0
2022, 3329, 0, "Ambiguous return value: Selected block modifies more than one local variable used in subsequent code. Affected variables are:  double[][] opoly9 int[] head int[] tail int[] v4 int[] pind int ic", 0, 0, 6, 6, 5, 1, 1, 0
1433, 3160, 0, "Ambiguous return value: Selected block modifies more than one local variable used in subsequent code. Affected variables are:  double[][] opoly9 int[] head int[] tail int[] v4", 0, 0, 17, 17, 12, 5, 5, 0
2650, 4345, 1, "OK", 4, 47, 10, 10, 6, 4, 4, 0
2362, 3035, 0, "Ambiguous return value: Selected block modifies more than one local variable used in subsequent code. Affected variables are:  double[][] opoly9 int[] head int[] tail", 0, 0, 4, 4, 3, 1, 1, 0
2517, 4377, 1, "OK", 3, 53, 11, 11, 7, 4, 4, 0
1050, 2751, 0, "Ambiguous return value: Selected block modifies more than one local variable used in subsequent code. Affected variables are:  double[][] p int maxinterval double[][] opoly9 int[] head", 0, 0, 14, 14, 10, 4, 4, 0
1319, 2605, 0, "Ambiguous return value: Selected block modifies more than one local variable used in subsequent code. Affected variables are:  int maxinterval int lenp", 0, 0, 14, 14, 10, 4, 4, 0
1764, 3147, 0, "Ambiguous return value: Selected block modifies more than one local variable used in subsequent code. Affected variables are:  double[][] opoly9 int[] head int[] tail int[] v4", 0, 0, 8, 8, 7, 1, 1, 0
1319, 4655, 1, "OK", 3, 86, 25, 25, 17, 8, 8, 0
2320, 4345, 1, "OK", 2, 57, 11, 11, 7, 4, 4, 0
3236, 4626, 0, "Ambiguous return value: Selected block modifies more than one local variable used in subsequent code. Affected variables are:  List<Double> lower List<Double> upper", 0, 0, 8, 8, 5, 3, 3, 0
2487, 3268, 0, "Ambiguous return value: Selected block modifies more than one local variable used in subsequent code. Affected variables are:  double[][] opoly9 int[] head int[] tail int[] v4", 0, 0, 4, 4, 3, 1, 1, 0
970, 3195, 0, "Ambiguous return value: Selected block modifies more than one local variable used in subsequent code. Affected variables are:  double[][] p double[][] opoly9 int[] head int[] tail int[] v4", 0, 0, 17, 17, 12, 5, 5, 0
1198, 2274, 0, "Ambiguous return value: Selected block modifies more than one local variable used in subsequent code. Affected variables are:  double[][] p double[][] rx9 double[][] ry9", 0, 0, 13, 13, 9, 4, 4, 0
1764, 3160, 0, "Ambiguous return value: Selected block modifies more than one local variable used in subsequent code. Affected variables are:  double[][] opoly9 int[] head int[] tail int[] v4", 0, 0, 8, 8, 7, 1, 1, 0
1198, 4324, 0, "Ambiguous return value: Selected block modifies more than one local variable used in subsequent code. Affected variables are:  double[][] opoly9 int[] pind", 0, 0, 24, 24, 16, 8, 8, 0
3463, 3745, 1, "OK", 6, 10, 2, 1, 1, 0, 1, 1
1893, 3268, 0, "Ambiguous return value: Selected block modifies more than one local variable used in subsequent code. Affected variables are:  double[][] opoly9 int[] head int[] tail int[] v4", 0, 0, 7, 7, 6, 1, 1, 0
2650, 4377, 1, "OK", 4, 48, 10, 10, 6, 4, 4, 0
1433, 3195, 0, "Ambiguous return value: Selected block modifies more than one local variable used in subsequent code. Affected variables are:  double[][] opoly9 int[] head int[] tail int[] v4", 0, 0, 17, 17, 12, 5, 5, 0
1319, 4682, 1, "OK", 3, 87, 25, 25, 17, 8, 8, 0
1198, 2294, 0, "Ambiguous return value: Selected block modifies more than one local variable used in subsequent code. Affected variables are:  double[][] p double[][] ry9", 0, 0, 13, 13, 9, 4, 4, 0
2320, 4377, 1, "OK", 2, 58, 11, 11, 7, 4, 4, 0
1198, 4345, 1, "OK", 1, 79, 24, 24, 16, 8, 8, 0
3236, 4655, 1, "OK", 7, 44, 8, 8, 5, 3, 3, 0
1319, 2644, 0, "Ambiguous return value: Selected block modifies more than one local variable used in subsequent code. Affected variables are:  int maxinterval int lenp", 0, 0, 14, 14, 10, 4, 4, 0
970, 3230, 0, "Ambiguous return value: Selected block modifies more than one local variable used in subsequent code. Affected variables are:  double[][] p double[][] opoly9 int[] head int[] tail int[] v4", 0, 0, 17, 17, 12, 5, 5, 0
2760, 3035, 1, "OK", 3, 7, 3, 3, 2, 1, 1, 0
1764, 3195, 0, "Ambiguous return value: Selected block modifies more than one local variable used in subsequent code. Affected variables are:  double[][] opoly9 int[] head int[] tail int[] v4", 0, 0, 8, 8, 7, 1, 1, 0
2487, 3312, 0, "Ambiguous return value: Selected block modifies more than one local variable used in subsequent code. Affected variables are:  double[][] opoly9 int[] head int[] tail int[] v4 int[] pind", 0, 0, 4, 4, 3, 1, 1, 0
1198, 2314, 1, "OK", 1, 22, 13, 13, 9, 4, 4, 0
1018, 1758, 0, "Ambiguous return value: Selected block modifies more than one local variable used in subsequent code. Affected variables are:  double[][] p double[][] rx9 double[][] ry9", 0, 0, 9, 9, 5, 4, 4, 0
1050, 2815, 0, "Ambiguous return value: Selected block modifies more than one local variable used in subsequent code. Affected variables are:  double[][] p int maxinterval double[][] opoly9 int[] head int[] tail", 0, 0, 14, 14, 10, 4, 4, 0
1433, 3230, 0, "Ambiguous return value: Selected block modifies more than one local variable used in subsequent code. Affected variables are:  double[][] opoly9 int[] head int[] tail int[] v4", 0, 0, 17, 17, 12, 5, 5, 0
3236, 4682, 1, "OK", 7, 45, 8, 8, 5, 3, 3, 0
2487, 3329, 0, "Ambiguous return value: Selected block modifies more than one local variable used in subsequent code. Affected variables are:  double[][] opoly9 int[] head int[] tail int[] v4 int[] pind int ic", 0, 0, 4, 4, 3, 1, 1, 0
3463, 3792, 0, "Ambiguous return value: Selected block modifies more than one local variable used in subsequent code. Affected variables are:  double[] kb1 double[] kb2", 0, 0, 2, 1, 1, 0, 1, 1
1198, 4377, 1, "OK", 1, 80, 24, 24, 16, 8, 8, 0
1893, 3312, 0, "Ambiguous return value: Selected block modifies more than one local variable used in subsequent code. Affected variables are:  double[][] opoly9 int[] head int[] tail int[] v4 int[] pind", 0, 0, 7, 7, 6, 1, 1, 0
940, 2145, 0, "Ambiguous return value: Selected block modifies more than one local variable used in subsequent code. Affected variables are:  double[][] p double[][] rx9 double[][] ry9", 0, 0, 12, 12, 8, 4, 4, 0
970, 3268, 0, "Ambiguous return value: Selected block modifies more than one local variable used in subsequent code. Affected variables are:  double[][] p double[][] opoly9 int[] head int[] tail int[] v4", 0, 0, 17, 17, 12, 5, 5, 0
1764, 3230, 0, "Ambiguous return value: Selected block modifies more than one local variable used in subsequent code. Affected variables are:  double[][] opoly9 int[] head int[] tail int[] v4", 0, 0, 8, 8, 7, 1, 1, 0
1319, 2690, 0, "Ambiguous return value: Selected block modifies more than one local variable used in subsequent code. Affected variables are:  int maxinterval double[][] opoly9", 0, 0, 14, 14, 10, 4, 4, 0
1893, 3329, 0, "Ambiguous return value: Selected block modifies more than one local variable used in subsequent code. Affected variables are:  double[][] opoly9 int[] head int[] tail int[] v4 int[] pind int ic", 0, 0, 7, 7, 6, 1, 1, 0
1217, 1758, 0, "Ambiguous return value: Selected block modifies more than one local variable used in subsequent code. Affected variables are:  double[][] p double[][] rx9 double[][] ry9", 0, 0, 9, 9, 5, 4, 4, 0
2824, 3147, 1, "OK", 4, 8, 3, 3, 2, 1, 1, 0
1275, 2016, 0, "Ambiguous return value: Selected block modifies more than one local variable used in subsequent code. Affected variables are:  double[][] rx9 double[][] ry9", 0, 0, 11, 11, 7, 4, 4, 0
1198, 2356, 0, "Ambiguous return value: Selected block modifies more than one local variable used in subsequent code. Affected variables are:  double[][] p double[][] c9", 0, 0, 13, 13, 9, 4, 4, 0
3515, 4260, 1, "OK", 8, 22, 6, 3, 3, 0, 3, 1
1433, 3268, 0, "Ambiguous return value: Selected block modifies more than one local variable used in subsequent code. Affected variables are:  double[][] opoly9 int[] head int[] tail int[] v4", 0, 0, 17, 17, 12, 5, 5, 0
2824, 3160, 1, "OK", 4, 9, 3, 3, 2, 1, 1, 0
1073, 2145, 0, "Ambiguous return value: Selected block modifies more than one local variable used in subsequent code. Affected variables are:  double[][] p double[][] rx9 double[][] ry9", 0, 0, 12, 12, 8, 4, 4, 0
2362, 3147, 0, "Ambiguous return value: Selected block modifies more than one local variable used in subsequent code. Affected variables are:  double[][] opoly9 int[] head int[] tail int[] v4", 0, 0, 4, 4, 3, 1, 1, 0
3463, 3832, 1, "OK", 6, 12, 2, 1, 1, 0, 1, 1
2696, 3035, 0, "Ambiguous return value: Selected block modifies more than one local variable used in subsequent code. Affected variables are:  int[] head int[] tail", 0, 0, 3, 3, 2, 1, 1, 0
1198, 2379, 1, "OK", 1, 24, 13, 13, 9, 4, 4, 0
2362, 3160, 0, "Ambiguous return value: Selected block modifies more than one local variable used in subsequent code. Affected variables are:  double[][] opoly9 int[] head int[] tail int[] v4", 0, 0, 4, 4, 3, 1, 1, 0
1764, 3268, 0, "Ambiguous return value: Selected block modifies more than one local variable used in subsequent code. Affected variables are:  double[][] opoly9 int[] head int[] tail int[] v4", 0, 0, 8, 8, 7, 1, 1, 0
2300, 3035, 0, "Ambiguous return value: Selected block modifies more than one local variable used in subsequent code. Affected variables are:  double[][] opoly9 int[] head int[] tail", 0, 0, 4, 4, 3, 1, 1, 0
2517, 4505, 0, "Ambiguous return value: Selected block modifies more than one local variable used in subsequent code. Affected variables are:  List<Double> lower List<Double> upper", 0, 0, 11, 11, 7, 4, 4, 0
970, 3312, 0, "Ambiguous return value: Selected block modifies more than one local variable used in subsequent code. Affected variables are:  double[][] p double[][] opoly9 int[] head int[] tail int[] v4 int[] pind", 0, 0, 17, 17, 12, 5, 5, 0
4297, 4626, 0, "Ambiguous return value: Selected block modifies more than one local variable used in subsequent code. Affected variables are:  List<Double> lower List<Double> upper", 0, 0, 1, 1, 1, 0, 0, 0
2824, 3195, 1, "OK", 4, 10, 3, 3, 2, 1, 1, 0
3318, 4267, 1, "OK", 7, 29, 7, 7, 4, 3, 3, 0
970, 3329, 0, "Ambiguous return value: Selected block modifies more than one local variable used in subsequent code. Affected variables are:  double[][] p double[][] opoly9 int[] head int[] tail int[] v4 int[] pind int ic", 0, 0, 17, 17, 12, 5, 5, 0
1433, 3312, 0, "Ambiguous return value: Selected block modifies more than one local variable used in subsequent code. Affected variables are:  double[][] opoly9 int[] head int[] tail int[] v4 int[] pind", 0, 0, 17, 17, 12, 5, 5, 0
1319, 2751, 0, "Ambiguous return value: Selected block modifies more than one local variable used in subsequent code. Affected variables are:  int maxinterval double[][] opoly9 int[] head", 0, 0, 14, 14, 10, 4, 4, 0
1376, 3035, 0, "Ambiguous return value: Selected block modifies more than one local variable used in subsequent code. Affected variables are:  double[][] opoly9 int[] head int[] tail", 0, 0, 17, 17, 12, 5, 5, 0
940, 4267, 0, "Ambiguous return value: Selected block modifies more than one local variable used in subsequent code. Affected variables are:  double[][] opoly9 int[] pind int ic", 0, 0, 24, 24, 16, 8, 8, 0
2650, 4505, 0, "Ambiguous return value: Selected block modifies more than one local variable used in subsequent code. Affected variables are:  List<Double> lower List<Double> upper", 0, 0, 10, 10, 6, 4, 4, 0
2362, 3195, 0, "Ambiguous return value: Selected block modifies more than one local variable used in subsequent code. Affected variables are:  double[][] opoly9 int[] head int[] tail int[] v4", 0, 0, 4, 4, 3, 1, 1, 0
2760, 3147, 0, "Ambiguous return value: Selected block modifies more than one local variable used in subsequent code. Affected variables are:  int[] tail int[] v4", 0, 0, 3, 3, 2, 1, 1, 0
4297, 4655, 1, "OK", 4, 13, 1, 1, 1, 0, 0, 0
1433, 3329, 0, "Ambiguous return value: Selected block modifies more than one local variable used in subsequent code. Affected variables are:  double[][] opoly9 int[] head int[] tail int[] v4 int[] pind int ic", 0, 0, 17, 17, 12, 5, 5, 0
2320, 4505, 0, "Ambiguous return value: Selected block modifies more than one local variable used in subsequent code. Affected variables are:  List<Double> lower List<Double> upper", 0, 0, 11, 11, 7, 4, 4, 0
1764, 3312, 0, "Ambiguous return value: Selected block modifies more than one local variable used in subsequent code. Affected variables are:  double[][] opoly9 int[] head int[] tail int[] v4 int[] pind", 0, 0, 8, 8, 7, 1, 1, 0
2760, 3160, 0, "Ambiguous return value: Selected block modifies more than one local variable used in subsequent code. Affected variables are:  int[] tail int[] v4", 0, 0, 3, 3, 2, 1, 1, 0
2824, 3230, 1, "OK", 4, 11, 3, 3, 2, 1, 1, 0
1073, 4267, 0, "Ambiguous return value: Selected block modifies more than one local variable used in subsequent code. Affected variables are:  double[][] opoly9 int[] pind int ic", 0, 0, 24, 24, 16, 8, 8, 0
1491, 1550, 1, "OK", 3, 1, 2, 1, 1, 0, 1, 1
1764, 3329, 0, "Ambiguous return value: Selected block modifies more than one local variable used in subsequent code. Affected variables are:  double[][] opoly9 int[] head int[] tail int[] v4 int[] pind int ic", 0, 0, 8, 8, 7, 1, 1, 0
4297, 4682, 1, "OK", 4, 14, 1, 1, 1, 0, 0, 0
2362, 3230, 0, "Ambiguous return value: Selected block modifies more than one local variable used in subsequent code. Affected variables are:  double[][] opoly9 int[] head int[] tail int[] v4", 0, 0, 4, 4, 3, 1, 1, 0
1018, 1887, 0, "Ambiguous return value: Selected block modifies more than one local variable used in subsequent code. Affected variables are:  double[][] p double[][] rx9 double[][] ry9", 0, 0, 10, 10, 6, 4, 4, 0
1198, 4505, 0, "Ambiguous return value: Selected block modifies more than one local variable used in subsequent code. Affected variables are:  List<Double> lower List<Double> upper", 0, 0, 24, 24, 16, 8, 8, 0
3318, 4324, 1, "OK", 7, 30, 7, 7, 4, 3, 3, 0
2760, 3195, 0, "Ambiguous return value: Selected block modifies more than one local variable used in subsequent code. Affected variables are:  int[] tail int[] v4", 0, 0, 3, 3, 2, 1, 1, 0
940, 2274, 0, "Ambiguous return value: Selected block modifies more than one local variable used in subsequent code. Affected variables are:  double[][] p double[][] rx9 double[][] ry9", 0, 0, 13, 13, 9, 4, 4, 0
940, 4324, 0, "Ambiguous return value: Selected block modifies more than one local variable used in subsequent code. Affected variables are:  double[][] opoly9 int[] pind", 0, 0, 24, 24, 16, 8, 8, 0
1319, 2815, 0, "Ambiguous return value: Selected block modifies more than one local variable used in subsequent code. Affected variables are:  int maxinterval double[][] opoly9 int[] head int[] tail", 0, 0, 14, 14, 10, 4, 4, 0
2824, 3268, 1, "OK", 4, 12, 3, 3, 2, 1, 1, 0
1217, 1887, 0, "Ambiguous return value: Selected block modifies more than one local variable used in subsequent code. Affected variables are:  double[][] p double[][] rx9 double[][] ry9", 0, 0, 10, 10, 6, 4, 4, 0
1198, 2481, 0, "Ambiguous return value: Selected block modifies more than one local variable used in subsequent code. Affected variables are:  double[][] p int maxinterval", 0, 0, 13, 13, 9, 4, 4, 0
2696, 3147, 0, "Ambiguous return value: Selected block modifies more than one local variable used in subsequent code. Affected variables are:  int[] head int[] tail int[] v4", 0, 0, 3, 3, 2, 1, 1, 0
3318, 4345, 1, "OK", 7, 31, 7, 7, 4, 3, 3, 0
1275, 2145, 0, "Ambiguous return value: Selected block modifies more than one local variable used in subsequent code. Affected variables are:  double[][] rx9 double[][] ry9", 0, 0, 12, 12, 8, 4, 4, 0
2362, 3268, 0, "Ambiguous return value: Selected block modifies more than one local variable used in subsequent code. Affected variables are:  double[][] opoly9 int[] head int[] tail int[] v4", 0, 0, 4, 4, 3, 1, 1, 0
940, 2294, 0, "Ambiguous return value: Selected block modifies more than one local variable used in subsequent code. Affected variables are:  double[][] p double[][] ry9", 0, 0, 13, 13, 9, 4, 4, 0
940, 4345, 1, "OK", 1, 87, 24, 24, 16, 8, 8, 0
2696, 3160, 0, "Ambiguous return value: Selected block modifies more than one local variable used in subsequent code. Affected variables are:  int[] head int[] tail int[] v4", 0, 0, 3, 3, 2, 1, 1, 0
2300, 3147, 0, "Ambiguous return value: Selected block modifies more than one local variable used in subsequent code. Affected variables are:  double[][] opoly9 int[] head int[] tail int[] v4", 0, 0, 4, 4, 3, 1, 1, 0
1073, 2274, 0, "Ambiguous return value: Selected block modifies more than one local variable used in subsequent code. Affected variables are:  double[][] p double[][] rx9 double[][] ry9", 0, 0, 13, 13, 9, 4, 4, 0
1073, 4324, 0, "Ambiguous return value: Selected block modifies more than one local variable used in subsequent code. Affected variables are:  double[][] opoly9 int[] pind", 0, 0, 24, 24, 16, 8, 8, 0
2760, 3230, 0, "Ambiguous return value: Selected block modifies more than one local variable used in subsequent code. Affected variables are:  int[] tail int[] v4", 0, 0, 3, 3, 2, 1, 1, 0
2300, 3160, 0, "Ambiguous return value: Selected block modifies more than one local variable used in subsequent code. Affected variables are:  double[][] opoly9 int[] head int[] tail int[] v4", 0, 0, 4, 4, 3, 1, 1, 0
940, 2314, 1, "OK", 1, 30, 13, 13, 9, 4, 4, 0
2517, 4626, 0, "Ambiguous return value: Selected block modifies more than one local variable used in subsequent code. Affected variables are:  List<Double> lower List<Double> upper", 0, 0, 12, 12, 8, 4, 4, 0
1491, 1617, 1, "OK", 3, 2, 4, 2, 2, 0, 2, 1
1198, 2511, 0, "Ambiguous return value: Selected block modifies more than one local variable used in subsequent code. Affected variables are:  double[][] p int maxinterval", 0, 0, 13, 13, 9, 4, 4, 0
3318, 4377, 1, "OK", 7, 32, 7, 7, 4, 3, 3, 0
1073, 2294, 0, "Ambiguous return value: Selected block modifies more than one local variable used in subsequent code. Affected variables are:  double[][] p double[][] ry9", 0, 0, 13, 13, 9, 4, 4, 0
3539, 3673, 1, "OK", 4, 4, 2, 1, 1, 0, 1, 1
2824, 3312, 0, "Ambiguous return value: Selected block modifies more than one local variable used in subsequent code. Affected variables are:  int[] v4 int[] pind", 0, 0, 3, 3, 2, 1, 1, 0
1073, 4345, 1, "OK", 1, 83, 24, 24, 16, 8, 8, 0
1376, 3147, 0, "Ambiguous return value: Selected block modifies more than one local variable used in subsequent code. Affected variables are:  double[][] opoly9 int[] head int[] tail int[] v4", 0, 0, 17, 17, 12, 5, 5, 0
940, 4377, 1, "OK", 1, 88, 24, 24, 16, 8, 8, 0
1198, 2530, 0, "Ambiguous return value: Selected block modifies more than one local variable used in subsequent code. Affected variables are:  double[][] p int maxinterval int lenp", 0, 0, 13, 13, 9, 4, 4, 0
2696, 3195, 0, "Ambiguous return value: Selected block modifies more than one local variable used in subsequent code. Affected variables are:  int[] head int[] tail int[] v4", 0, 0, 3, 3, 2, 1, 1, 0
2362, 3312, 0, "Ambiguous return value: Selected block modifies more than one local variable used in subsequent code. Affected variables are:  double[][] opoly9 int[] head int[] tail int[] v4 int[] pind", 0, 0, 4, 4, 3, 1, 1, 0
2517, 2605, 1, "OK", 1, 4, 1, 1, 1, 0, 0, 0
2650, 4626, 0, "Ambiguous return value: Selected block modifies more than one local variable used in subsequent code. Affected variables are:  List<Double> lower List<Double> upper", 0, 0, 11, 11, 7, 4, 4, 0
1376, 3160, 0, "Ambiguous return value: Selected block modifies more than one local variable used in subsequent code. Affected variables are:  double[][] opoly9 int[] head int[] tail int[] v4", 0, 0, 17, 17, 12, 5, 5, 0
1073, 2314, 1, "OK", 1, 26, 13, 13, 9, 4, 4, 0
2517, 4655, 1, "OK", 4, 63, 12, 12, 8, 4, 4, 0
2824, 3329, 0, "Ambiguous return value: Selected block modifies more than one local variable used in subsequent code. Affected variables are:  int[] v4 int[] pind int ic", 0, 0, 3, 3, 2, 1, 1, 0
2760, 3268, 0, "Ambiguous return value: Selected block modifies more than one local variable used in subsequent code. Affected variables are:  int[] tail int[] v4", 0, 0, 3, 3, 2, 1, 1, 0
1558, 1617, 1, "OK", 3, 1, 2, 1, 1, 0, 1, 1
2300, 3195, 0, "Ambiguous return value: Selected block modifies more than one local variable used in subsequent code. Affected variables are:  double[][] opoly9 int[] head int[] tail int[] v4", 0, 0, 4, 4, 3, 1, 1, 0
1050, 3035, 0, "Ambiguous return value: Selected block modifies more than one local variable used in subsequent code. Affected variables are:  double[][] p double[][] opoly9 int[] head int[] tail", 0, 0, 17, 17, 12, 5, 5, 0
2320, 4626, 0, "Ambiguous return value: Selected block modifies more than one local variable used in subsequent code. Affected variables are:  List<Double> lower List<Double> upper", 0, 0, 12, 12, 8, 4, 4, 0
940, 2356, 0, "Ambiguous return value: Selected block modifies more than one local variable used in subsequent code. Affected variables are:  double[][] p double[][] c9", 0, 0, 13, 13, 9, 4, 4, 0
1073, 4377, 1, "OK", 1, 84, 24, 24, 16, 8, 8, 0
2362, 3329, 0, "Ambiguous return value: Selected block modifies more than one local variable used in subsequent code. Affected variables are:  double[][] opoly9 int[] head int[] tail int[] v4 int[] pind int ic", 0, 0, 4, 4, 3, 1, 1, 0
3463, 4023, 0, "Ambiguous return value: Selected block modifies more than one local variable used in subsequent code. Affected variables are:  double[] interp int ic", 0, 0, 4, 2, 2, 0, 2, 1
1275, 4267, 0, "Ambiguous return value: Selected block modifies more than one local variable used in subsequent code. Affected variables are:  double[][] opoly9 int[] pind int ic", 0, 0, 24, 24, 16, 8, 8, 0
2696, 3230, 0, "Ambiguous return value: Selected block modifies more than one local variable used in subsequent code. Affected variables are:  int[] head int[] tail int[] v4", 0, 0, 3, 3, 2, 1, 1, 0
3125, 4267, 0, "Ambiguous return value: Selected block modifies more than one local variable used in subsequent code. Affected variables are:  int[] pind int ic", 0, 0, 7, 7, 4, 3, 3, 0
2517, 4682, 1, "OK", 4, 64, 12, 12, 8, 4, 4, 0
2650, 4655, 1, "OK", 5, 58, 11, 11, 7, 4, 4, 0
1376, 3195, 0, "Ambiguous return value: Selected block modifies more than one local variable used in subsequent code. Affected variables are:  double[][] opoly9 int[] head int[] tail int[] v4", 0, 0, 17, 17, 12, 5, 5, 0
2320, 2605, 0, "Ambiguous return value: Selected block modifies more than one local variable used in subsequent code. Affected variables are:  int maxinterval int lenp", 0, 0, 1, 1, 1, 0, 0, 0
940, 2379, 1, "OK", 1, 32, 13, 13, 9, 4, 4, 0
2320, 4655, 1, "OK", 3, 68, 12, 12, 8, 4, 4, 0
2517, 2644, 1, "OK", 2, 5, 1, 1, 1, 0, 0, 0
2300, 3230, 0, "Ambiguous return value: Selected block modifies more than one local variable used in subsequent code. Affected variables are:  double[][] opoly9 int[] head int[] tail int[] v4", 0, 0, 4, 4, 3, 1, 1, 0
1491, 1684, 1, "OK", 4, 3, 6, 3, 3, 0, 3, 1
1073, 2356, 0, "Ambiguous return value: Selected block modifies more than one local variable used in subsequent code. Affected variables are:  double[][] p double[][] c9", 0, 0, 13, 13, 9, 4, 4, 0
1198, 4626, 0, "Ambiguous return value: Selected block modifies more than one local variable used in subsequent code. Affected variables are:  List<Double> lower List<Double> upper", 0, 0, 25, 25, 17, 8, 8, 0
1018, 2016, 0, "Ambiguous return value: Selected block modifies more than one local variable used in subsequent code. Affected variables are:  double[][] p double[][] rx9 double[][] ry9", 0, 0, 11, 11, 7, 4, 4, 0
2760, 3312, 0, "Ambiguous return value: Selected block modifies more than one local variable used in subsequent code. Affected variables are:  int[] tail int[] v4 int[] pind", 0, 0, 3, 3, 2, 1, 1, 0
3539, 3745, 1, "OK", 5, 7, 2, 1, 1, 0, 1, 1
2650, 4682, 1, "OK", 5, 59, 11, 11, 7, 4, 4, 0
2320, 4682, 1, "OK", 3, 69, 12, 12, 8, 4, 4, 0
1073, 2379, 1, "OK", 1, 28, 13, 13, 9, 4, 4, 0
2760, 3329, 0, "Ambiguous return value: Selected block modifies more than one local variable used in subsequent code. Affected variables are:  int[] tail int[] v4 int[] pind int ic", 0, 0, 3, 3, 2, 1, 1, 0
2696, 3268, 0, "Ambiguous return value: Selected block modifies more than one local variable used in subsequent code. Affected variables are:  int[] head int[] tail int[] v4", 0, 0, 3, 3, 2, 1, 1, 0
1376, 3230, 0, "Ambiguous return value: Selected block modifies more than one local variable used in subsequent code. Affected variables are:  double[][] opoly9 int[] head int[] tail int[] v4", 0, 0, 17, 17, 12, 5, 5, 0
1558, 1684, 1, "OK", 4, 2, 4, 2, 2, 0, 2, 1
1198, 2605, 0, "Ambiguous return value: Selected block modifies more than one local variable used in subsequent code. Affected variables are:  double[][] p int maxinterval int lenp", 0, 0, 14, 14, 10, 4, 4, 0
1217, 2016, 0, "Ambiguous return value: Selected block modifies more than one local variable used in subsequent code. Affected variables are:  double[][] p double[][] rx9 double[][] ry9", 0, 0, 11, 11, 7, 4, 4, 0
1198, 4655, 1, "OK", 2, 90, 25, 25, 17, 8, 8, 0
2320, 2644, 0, "Ambiguous return value: Selected block modifies more than one local variable used in subsequent code. Affected variables are:  int maxinterval int lenp", 0, 0, 1, 1, 1, 0, 0, 0
1275, 2274, 0, "Ambiguous return value: Selected block modifies more than one local variable used in subsequent code. Affected variables are:  double[][] rx9 double[][] ry9", 0, 0, 13, 13, 9, 4, 4, 0
2300, 3268, 0, "Ambiguous return value: Selected block modifies more than one local variable used in subsequent code. Affected variables are:  double[][] opoly9 int[] head int[] tail int[] v4", 0, 0, 4, 4, 3, 1, 1, 0
1275, 4324, 0, "Ambiguous return value: Selected block modifies more than one local variable used in subsequent code. Affected variables are:  double[][] opoly9 int[] pind", 0, 0, 24, 24, 16, 8, 8, 0
2517, 2690, 1, "OK", 2, 6, 1, 1, 1, 0, 0, 0
3125, 4324, 1, "OK", 5, 36, 7, 7, 4, 3, 3, 0
1275, 2294, 1, "OK", 2, 19, 13, 13, 9, 4, 4, 0
1625, 1684, 1, "OK", 3, 1, 2, 1, 1, 0, 1, 1
1198, 4682, 1, "OK", 2, 91, 25, 25, 17, 8, 8, 0
1275, 4345, 1, "OK", 2, 77, 24, 24, 16, 8, 8, 0
3539, 3792, 0, "Ambiguous return value: Selected block modifies more than one local variable used in subsequent code. Affected variables are:  double[] kb1 double[] kb2", 0, 0, 2, 1, 1, 0, 1, 1
3125, 4345, 1, "OK", 5, 37, 7, 7, 4, 3, 3, 0
1376, 3268, 0, "Ambiguous return value: Selected block modifies more than one local variable used in subsequent code. Affected variables are:  double[][] opoly9 int[] head int[] tail int[] v4", 0, 0, 17, 17, 12, 5, 5, 0
3318, 4505, 0, "Ambiguous return value: Selected block modifies more than one local variable used in subsequent code. Affected variables are:  List<Double> lower List<Double> upper", 0, 0, 7, 7, 4, 3, 3, 0
1491, 1751, 1, "OK", 4, 4, 8, 4, 4, 0, 4, 1
3411, 3673, 1, "OK", 7, 9, 2, 1, 1, 0, 1, 1
1198, 2644, 0, "Ambiguous return value: Selected block modifies more than one local variable used in subsequent code. Affected variables are:  double[][] p int maxinterval int lenp", 0, 0, 14, 14, 10, 4, 4, 0
2696, 3312, 0, "Ambiguous return value: Selected block modifies more than one local variable used in subsequent code. Affected variables are:  int[] head int[] tail int[] v4 int[] pind", 0, 0, 3, 3, 2, 1, 1, 0
940, 4505, 0, "Ambiguous return value: Selected block modifies more than one local variable used in subsequent code. Affected variables are:  List<Double> lower List<Double> upper", 0, 0, 24, 24, 16, 8, 8, 0
1275, 2314, 1, "OK", 2, 20, 13, 13, 9, 4, 4, 0
1050, 3147, 0, "Ambiguous return value: Selected block modifies more than one local variable used in subsequent code. Affected variables are:  double[][] p double[][] opoly9 int[] head int[] tail int[] v4", 0, 0, 17, 17, 12, 5, 5, 0
2320, 2690, 0, "Ambiguous return value: Selected block modifies more than one local variable used in subsequent code. Affected variables are:  int maxinterval double[][] opoly9", 0, 0, 1, 1, 1, 0, 0, 0
2300, 3312, 0, "Ambiguous return value: Selected block modifies more than one local variable used in subsequent code. Affected variables are:  double[][] opoly9 int[] head int[] tail int[] v4 int[] pind", 0, 0, 4, 4, 3, 1, 1, 0
2696, 3329, 0, "Ambiguous return value: Selected block modifies more than one local variable used in subsequent code. Affected variables are:  int[] head int[] tail int[] v4 int[] pind int ic", 0, 0, 3, 3, 2, 1, 1, 0
1050, 3160, 0, "Ambiguous return value: Selected block modifies more than one local variable used in subsequent code. Affected variables are:  double[][] p double[][] opoly9 int[] head int[] tail int[] v4", 0, 0, 17, 17, 12, 5, 5, 0
1275, 4377, 1, "OK", 2, 78, 24, 24, 16, 8, 8, 0
1558, 1751, 1, "OK", 4, 3, 6, 3, 3, 0, 3, 1
3125, 4377, 1, "OK", 5, 38, 7, 7, 4, 3, 3, 0
940, 2481, 0, "Ambiguous return value: Selected block modifies more than one local variable used in subsequent code. Affected variables are:  double[][] p int maxinterval", 0, 0, 13, 13, 9, 4, 4, 0
2300, 3329, 0, "Ambiguous return value: Selected block modifies more than one local variable used in subsequent code. Affected variables are:  double[][] opoly9 int[] head int[] tail int[] v4 int[] pind int ic", 0, 0, 4, 4, 3, 1, 1, 0
3539, 3832, 1, "OK", 5, 9, 2, 1, 1, 0, 1, 1
1073, 4505, 0, "Ambiguous return value: Selected block modifies more than one local variable used in subsequent code. Affected variables are:  List<Double> lower List<Double> upper", 0, 0, 24, 24, 16, 8, 8, 0
2517, 2751, 0, "Ambiguous return value: Selected block modifies more than one local variable used in subsequent code. Affected variables are:  double[][] opoly9 int[] head", 0, 0, 1, 1, 1, 0, 0, 0
1376, 3312, 0, "Ambiguous return value: Selected block modifies more than one local variable used in subsequent code. Affected variables are:  double[][] opoly9 int[] head int[] tail int[] v4 int[] pind", 0, 0, 17, 17, 12, 5, 5, 0
1198, 2690, 0, "Ambiguous return value: Selected block modifies more than one local variable used in subsequent code. Affected variables are:  double[][] p int maxinterval double[][] opoly9", 0, 0, 14, 14, 10, 4, 4, 0
1319, 3035, 0, "Ambiguous return value: Selected block modifies more than one local variable used in subsequent code. Affected variables are:  double[][] opoly9 int[] head int[] tail", 0, 0, 17, 17, 12, 5, 5, 0
1275, 2356, 1, "OK", 2, 21, 13, 13, 9, 4, 4, 0
1625, 1751, 1, "OK", 3, 2, 4, 2, 2, 0, 2, 1
1073, 2481, 0, "Ambiguous return value: Selected block modifies more than one local variable used in subsequent code. Affected variables are:  double[][] p int maxinterval", 0, 0, 13, 13, 9, 4, 4, 0
1050, 3195, 0, "Ambiguous return value: Selected block modifies more than one local variable used in subsequent code. Affected variables are:  double[][] p double[][] opoly9 int[] head int[] tail int[] v4", 0, 0, 17, 17, 12, 5, 5, 0
1376, 3329, 0, "Ambiguous return value: Selected block modifies more than one local variable used in subsequent code. Affected variables are:  double[][] opoly9 int[] head int[] tail int[] v4 int[] pind int ic", 0, 0, 17, 17, 12, 5, 5, 0
940, 2511, 0, "Ambiguous return value: Selected block modifies more than one local variable used in subsequent code. Affected variables are:  double[][] p int maxinterval", 0, 0, 13, 13, 9, 4, 4, 0
1018, 2145, 0, "Ambiguous return value: Selected block modifies more than one local variable used in subsequent code. Affected variables are:  double[][] p double[][] rx9 double[][] ry9", 0, 0, 12, 12, 8, 4, 4, 0
3411, 3745, 1, "OK", 8, 12, 2, 1, 1, 0, 1, 1
1275, 2379, 1, "OK", 2, 22, 13, 13, 9, 4, 4, 0
2320, 2751, 0, "Ambiguous return value: Selected block modifies more than one local variable used in subsequent code. Affected variables are:  int maxinterval double[][] opoly9 int[] head", 0, 0, 1, 1, 1, 0, 0, 0
940, 2530, 0, "Ambiguous return value: Selected block modifies more than one local variable used in subsequent code. Affected variables are:  double[][] p int maxinterval int lenp", 0, 0, 13, 13, 9, 4, 4, 0
1692, 1751, 1, "OK", 3, 1, 2, 1, 1, 0, 1, 1
1073, 2511, 0, "Ambiguous return value: Selected block modifies more than one local variable used in subsequent code. Affected variables are:  double[][] p int maxinterval", 0, 0, 13, 13, 9, 4, 4, 0
1217, 2145, 0, "Ambiguous return value: Selected block modifies more than one local variable used in subsequent code. Affected variables are:  double[][] p double[][] rx9 double[][] ry9", 0, 0, 12, 12, 8, 4, 4, 0
1050, 3230, 0, "Ambiguous return value: Selected block modifies more than one local variable used in subsequent code. Affected variables are:  double[][] p double[][] opoly9 int[] head int[] tail int[] v4", 0, 0, 17, 17, 12, 5, 5, 0
2536, 4267, 0, "Ambiguous return value: Selected block modifies more than one local variable used in subsequent code. Affected variables are:  double[][] opoly9 int[] pind int ic", 0, 0, 11, 11, 7, 4, 4, 0
2517, 2815, 0, "Ambiguous return value: Selected block modifies more than one local variable used in subsequent code. Affected variables are:  double[][] opoly9 int[] head int[] tail", 0, 0, 1, 1, 1, 0, 0, 0
1073, 2530, 0, "Ambiguous return value: Selected block modifies more than one local variable used in subsequent code. Affected variables are:  double[][] p int maxinterval int lenp", 0, 0, 13, 13, 9, 4, 4, 0
1198, 2751, 0, "Ambiguous return value: Selected block modifies more than one local variable used in subsequent code. Affected variables are:  double[][] p int maxinterval double[][] opoly9 int[] head", 0, 0, 14, 14, 10, 4, 4, 0
3318, 4626, 0, "Ambiguous return value: Selected block modifies more than one local variable used in subsequent code. Affected variables are:  List<Double> lower List<Double> upper", 0, 0, 8, 8, 5, 3, 3, 0
3411, 3792, 0, "Ambiguous return value: Selected block modifies more than one local variable used in subsequent code. Affected variables are:  double[] kb1 double[] kb2", 0, 0, 2, 1, 1, 0, 1, 1
3800, 4023, 0, "Ambiguous return value: Selected block modifies more than one local variable used in subsequent code. Affected variables are:  double[] interp int ic", 0, 0, 2, 1, 1, 0, 1, 1
940, 4626, 0, "Ambiguous return value: Selected block modifies more than one local variable used in subsequent code. Affected variables are:  List<Double> lower List<Double> upper", 0, 0, 25, 25, 17, 8, 8, 0
1050, 3268, 0, "Ambiguous return value: Selected block modifies more than one local variable used in subsequent code. Affected variables are:  double[][] p double[][] opoly9 int[] head int[] tail int[] v4", 0, 0, 17, 17, 12, 5, 5, 0
2320, 2815, 0, "Ambiguous return value: Selected block modifies more than one local variable used in subsequent code. Affected variables are:  int maxinterval double[][] opoly9 int[] head int[] tail", 0, 0, 1, 1, 1, 0, 0, 0
1018, 4267, 0, "Ambiguous return value: Selected block modifies more than one local variable used in subsequent code. Affected variables are:  double[][] opoly9 int[] pind int ic", 0, 0, 24, 24, 16, 8, 8, 0
3318, 4655, 1, "OK", 8, 42, 8, 8, 5, 3, 3, 0
2536, 4324, 0, "Ambiguous return value: Selected block modifies more than one local variable used in subsequent code. Affected variables are:  double[][] opoly9 int[] pind", 0, 0, 11, 11, 7, 4, 4, 0
3867, 4023, 1, "OK", 7, 5, 2, 1, 1, 0, 1, 1
1275, 4505, 0, "Ambiguous return value: Selected block modifies more than one local variable used in subsequent code. Affected variables are:  List<Double> lower List<Double> upper", 0, 0, 24, 24, 16, 8, 8, 0
3463, 4260, 1, "OK", 8, 24, 6, 3, 3, 0, 3, 1
940, 2605, 0, "Ambiguous return value: Selected block modifies more than one local variable used in subsequent code. Affected variables are:  double[][] p int maxinterval int lenp", 0, 0, 14, 14, 10, 4, 4, 0
1073, 4626, 0, "Ambiguous return value: Selected block modifies more than one local variable used in subsequent code. Affected variables are:  List<Double> lower List<Double> upper", 0, 0, 25, 25, 17, 8, 8, 0
940, 4655, 1, "OK", 2, 98, 25, 25, 17, 8, 8, 0
3125, 4505, 0, "Ambiguous return value: Selected block modifies more than one local variable used in subsequent code. Affected variables are:  List<Double> lower List<Double> upper", 0, 0, 7, 7, 4, 3, 3, 0
1319, 3147, 0, "Ambiguous return value: Selected block modifies more than one local variable used in subsequent code. Affected variables are:  double[][] opoly9 int[] head int[] tail int[] v4", 0, 0, 17, 17, 12, 5, 5, 0
3411, 3832, 1, "OK", 8, 14, 2, 1, 1, 0, 1, 1
1217, 4267, 0, "Ambiguous return value: Selected block modifies more than one local variable used in subsequent code. Affected variables are:  double[][] opoly9 int[] pind int ic", 0, 0, 24, 24, 16, 8, 8, 0
1198, 2815, 0, "Ambiguous return value: Selected block modifies more than one local variable used in subsequent code. Affected variables are:  double[][] p int maxinterval double[][] opoly9 int[] head int[] tail", 0, 0, 14, 14, 10, 4, 4, 0
1319, 3160, 0, "Ambiguous return value: Selected block modifies more than one local variable used in subsequent code. Affected variables are:  double[][] opoly9 int[] head int[] tail int[] v4", 0, 0, 17, 17, 12, 5, 5, 0
2536, 4345, 1, "OK", 4, 51, 11, 11, 7, 4, 4, 0
3318, 4682, 1, "OK", 8, 43, 8, 8, 5, 3, 3, 0
1050, 3312, 0, "Ambiguous return value: Selected block modifies more than one local variable used in subsequent code. Affected variables are:  double[][] p double[][] opoly9 int[] head int[] tail int[] v4 int[] pind", 0, 0, 17, 17, 12, 5, 5, 0
1275, 2481, 1, "OK", 2, 24, 13, 13, 9, 4, 4, 0
1073, 2605, 0, "Ambiguous return value: Selected block modifies more than one local variable used in subsequent code. Affected variables are:  double[][] p int maxinterval int lenp", 0, 0, 14, 14, 10, 4, 4, 0
940, 4682, 1, "OK", 2, 99, 25, 25, 17, 8, 8, 0
1073, 4655, 1, "OK", 2, 94, 25, 25, 17, 8, 8, 0
1050, 3329, 0, "Ambiguous return value: Selected block modifies more than one local variable used in subsequent code. Affected variables are:  double[][] p double[][] opoly9 int[] head int[] tail int[] v4 int[] pind int ic", 0, 0, 17, 17, 12, 5, 5, 0
940, 2644, 0, "Ambiguous return value: Selected block modifies more than one local variable used in subsequent code. Affected variables are:  double[][] p int maxinterval int lenp", 0, 0, 14, 14, 10, 4, 4, 0
1018, 2274, 0, "Ambiguous return value: Selected block modifies more than one local variable used in subsequent code. Affected variables are:  double[][] p double[][] rx9 double[][] ry9", 0, 0, 13, 13, 9, 4, 4, 0
1018, 4324, 0, "Ambiguous return value: Selected block modifies more than one local variable used in subsequent code. Affected variables are:  double[][] opoly9 int[] pind", 0, 0, 24, 24, 16, 8, 8, 0
2536, 4377, 1, "OK", 4, 52, 11, 11, 7, 4, 4, 0
1275, 2511, 1, "OK", 2, 25, 13, 13, 9, 4, 4, 0
1319, 3195, 0, "Ambiguous return value: Selected block modifies more than one local variable used in subsequent code. Affected variables are:  double[][] opoly9 int[] head int[] tail int[] v4", 0, 0, 17, 17, 12, 5, 5, 0
1073, 4682, 1, "OK", 2, 95, 25, 25, 17, 8, 8, 0
1018, 2294, 0, "Ambiguous return value: Selected block modifies more than one local variable used in subsequent code. Affected variables are:  double[][] p double[][] ry9", 0, 0, 13, 13, 9, 4, 4, 0