A, B, feasible, reason, parameters, extractedLOC, reductionCC, extractedMethodCC, accumulatedInherentComponent, accumulatedNestingComponent, numberNestingContributors, nesting
11576, 11901, 0, "Ambiguous return value: Selected block modifies more than one local variable used in subsequent code. Affected variables are:  double[] arrCondition double[] peaks", 0, 0, 2, 1, 1, 0, 1, 1
7804, 8002, 1, "OK", 6, 6, 4, 1, 1, 0, 1, 3
9765, 10695, 1, "OK", 5, 33, 16, 10, 6, 4, 6, 1
9681, 10236, 0, "Ambiguous return value: Selected block modifies more than one local variable used in subsequent code. Affected variables are:  double[] xopt double[] tmp2 double[] b double[][] M", 0, 0, 14, 9, 5, 4, 5, 1
8593, 9149, 0, "Ambiguous return value: Selected block modifies more than one local variable used in subsequent code. Affected variables are:  double[] zeros double[] b double[][] M double[][] rot1 BBOBFunction problem", 0, 0, 5, 3, 2, 1, 2, 1
7635, 8123, 1, "OK", 6, 17, 9, 6, 3, 3, 3, 1
9561, 10881, 1, "OK", 4, 41, 16, 10, 6, 4, 6, 1
10916, 11883, 0, "Ambiguous return value: Selected block modifies more than one local variable used in subsequent code. Affected variables are:  int numberOfPeaks double maxcondition double b double c double[] fitvalues double[] xopt double fopt double[][] xLocal double[][] arrScales double[][] rotation List<Integer> rperm double[] arrCondition double[] peaks", 0, 0, 2, 1, 1, 0, 1, 1
4266, 5046, 0, "Ambiguous return value: Selected block modifies more than one local variable used in subsequent code. Affected variables are:  double[] b double[][] M BBOBFunction problem", 0, 0, 9, 6, 3, 3, 3, 1
6133, 6565, 1, "OK", 5, 16, 9, 6, 3, 3, 3, 1
4501, 4933, 1, "OK", 6, 15, 9, 6, 3, 3, 3, 1
5334, 5734, 1, "OK", 2, 11, 2, 1, 1, 0, 1, 1
7559, 8438, 1, "OK", 7, 24, 9, 6, 3, 3, 3, 1
9804, 10523, 0, "Ambiguous return value: Selected block modifies more than one local variable used in subsequent code. Affected variables are:  double[][] M BBOBFunction problem", 0, 0, 16, 10, 6, 4, 6, 1
4305, 4878, 0, "Ambiguous return value: Selected block modifies more than one local variable used in subsequent code. Affected variables are:  double[][] M BBOBFunction problem", 0, 0, 9, 6, 3, 3, 3, 1
10916, 11901, 0, "Ambiguous return value: Selected block modifies more than one local variable used in subsequent code. Affected variables are:  int numberOfPeaks double maxcondition double b double c double[] fitvalues double[] xopt double fopt double[][] xLocal double[][] arrScales double[][] rotation List<Integer> rperm double[] arrCondition double[] peaks", 0, 0, 2, 1, 1, 0, 1, 1
4206, 4878, 0, "Ambiguous return value: Selected block modifies more than one local variable used in subsequent code. Affected variables are:  double fopt double[] b double[][] M BBOBFunction problem", 0, 0, 9, 6, 3, 3, 3, 1
11803, 13088, 1, "OK", 14, 44, 23, 15, 8, 7, 8, 1
7364, 8362, 1, "OK", 4, 27, 9, 6, 3, 3, 3, 1
10944, 13088, 0, "Ambiguous return value: Selected block modifies more than one local variable used in subsequent code. Affected variables are:  double fopt BBOBFunction problem", 0, 0, 25, 16, 9, 7, 9, 1
7702, 8123, 1, "OK", 6, 15, 9, 6, 3, 3, 3, 1
10977, 13088, 0, "Ambiguous return value: Selected block modifies more than one local variable used in subsequent code. Affected variables are:  double fopt BBOBFunction problem", 0, 0, 25, 16, 9, 7, 9, 1
9723, 9991, 0, "Ambiguous return value: Selected block modifies more than one local variable used in subsequent code. Affected variables are:  double[] tmp2 double[] b double[][] M", 0, 0, 5, 3, 2, 1, 2, 1
7467, 8242, 0, "Ambiguous return value: Selected block modifies more than one local variable used in subsequent code. Affected variables are:  double[][] rot1 BBOBFunction problem", 0, 0, 9, 6, 3, 3, 3, 1
6200, 6565, 1, "OK", 5, 14, 9, 6, 3, 3, 3, 1
7304, 8181, 0, "Ambiguous return value: Selected block modifies more than one local variable used in subsequent code. Affected variables are:  double[] xopt double[] zeros double[][] rot1 BBOBFunction problem", 0, 0, 9, 6, 3, 3, 3, 1
4434, 4989, 1, "OK", 6, 18, 9, 6, 3, 3, 3, 1
5965, 6680, 1, "OK", 3, 22, 9, 6, 3, 3, 3, 1
11451, 11716, 1, "OK", 2, 8, 2, 1, 1, 0, 1, 1
9996, 10751, 1, "OK", 7, 23, 11, 7, 4, 3, 4, 1
11141, 13145, 1, "OK", 11, 62, 25, 16, 9, 7, 9, 1
7506, 8066, 0, "Ambiguous return value: Selected block modifies more than one local variable used in subsequent code. Affected variables are:  double[][] M double[][] rot1 BBOBFunction problem", 0, 0, 9, 6, 3, 3, 3, 1
11022, 11716, 0, "Ambiguous return value: Selected block modifies more than one local variable used in subsequent code. Affected variables are:  double b double c double[] fitvalues double[] xopt double fopt double[][] xLocal double[][] arrScales double[][] rotation List<Integer> rperm", 0, 0, 2, 1, 1, 0, 1, 1
5274, 5583, 0, "Ambiguous return value: Selected block modifies more than one local variable used in subsequent code. Affected variables are:  double fopt BBOBFunction problem", 0, 0, 2, 1, 1, 0, 1, 1
12566, 12999, 1, "OK", 8, 17, 13, 9, 4, 5, 4, 1
8728, 9096, 1, "OK", 4, 11, 5, 3, 2, 1, 2, 1
11061, 12561, 0, "Ambiguous return value: Selected block modifies more than one local variable used in subsequent code. Affected variables are:  double[] xopt double fopt double[][] xLocal double[][] arrScales double[][] rotation double[] peaks", 0, 0, 12, 7, 5, 2, 5, 1
5905, 6511, 0, "Ambiguous return value: Selected block modifies more than one local variable used in subsequent code. Affected variables are:  double fopt double[] b double[][] M", 0, 0, 9, 6, 3, 3, 3, 1
11042, 13145, 1, "OK", 8, 65, 25, 16, 9, 7, 9, 1
6004, 6511, 1, "OK", 3, 17, 9, 6, 3, 3, 3, 1
9765, 10751, 1, "OK", 5, 34, 16, 10, 6, 4, 6, 1
7635, 8181, 1, "OK", 6, 18, 9, 6, 3, 3, 3, 1
12732, 12994, 1, "OK", 8, 11, 11, 5, 3, 2, 3, 2
8593, 9206, 0, "Ambiguous return value: Selected block modifies more than one local variable used in subsequent code. Affected variables are:  double[] zeros double[] b double[][] M double[][] rot1 BBOBFunction problem", 0, 0, 5, 3, 2, 1, 2, 1
11042, 12135, 0, "Ambiguous return value: Selected block modifies more than one local variable used in subsequent code. Affected variables are:  double c double[] xopt double fopt double[][] xLocal double[][] arrScales double[][] rotation List<Integer> rperm double[] arrCondition double[] peaks", 0, 0, 4, 2, 2, 0, 2, 1
11906, 12999, 1, "OK", 14, 37, 23, 15, 8, 7, 8, 1
5820, 13249, 1, "OK", 4, 212, 71, 71, 30, 41, 23, 0
6302, 6500, 1, "OK", 6, 6, 4, 1, 1, 0, 1, 3
4266, 5104, 1, "OK", 4, 24, 9, 6, 3, 3, 3, 1
11141, 12135, 0, "Ambiguous return value: Selected block modifies more than one local variable used in subsequent code. Affected variables are:  double fopt double[][] xLocal double[][] arrScales double[][] rotation List<Integer> rperm double[] arrCondition double[] peaks", 0, 0, 4, 2, 2, 0, 2, 1
11887, 12561, 1, "OK", 9, 21, 10, 6, 4, 2, 4, 1
5334, 5791, 1, "OK", 3, 12, 2, 1, 1, 0, 1, 1
6133, 6622, 1, "OK", 6, 17, 9, 6, 3, 3, 3, 1
4501, 4989, 1, "OK", 6, 16, 9, 6, 3, 3, 3, 1
11524, 12561, 1, "OK", 8, 34, 12, 7, 5, 2, 5, 1
9804, 10580, 0, "Ambiguous return value: Selected block modifies more than one local variable used in subsequent code. Affected variables are:  double[][] M BBOBFunction problem", 0, 0, 16, 10, 6, 4, 6, 1
11141, 13164, 1, "OK", 11, 63, 25, 16, 9, 7, 9, 1
11840, 12999, 1, "OK", 13, 40, 23, 15, 8, 7, 8, 1
11042, 13164, 1, "OK", 8, 66, 25, 16, 9, 7, 9, 1
11326, 12561, 0, "Ambiguous return value: Selected block modifies more than one local variable used in subsequent code. Affected variables are:  double[][] rotation double[] peaks", 0, 0, 12, 7, 5, 2, 5, 1
10241, 10358, 1, "OK", 4, 4, 2, 1, 1, 0, 1, 1
11576, 12999, 1, "OK", 14, 50, 25, 16, 9, 7, 9, 1
4305, 4933, 0, "Ambiguous return value: Selected block modifies more than one local variable used in subsequent code. Affected variables are:  double[][] M BBOBFunction problem", 0, 0, 9, 6, 3, 3, 3, 1
4206, 4933, 0, "Ambiguous return value: Selected block modifies more than one local variable used in subsequent code. Affected variables are:  double fopt double[] b double[][] M BBOBFunction problem", 0, 0, 9, 6, 3, 3, 3, 1
11803, 13145, 1, "OK", 15, 45, 23, 15, 8, 7, 8, 1
7467, 8297, 0, "Ambiguous return value: Selected block modifies more than one local variable used in subsequent code. Affected variables are:  double[][] rot1 BBOBFunction problem", 0, 0, 9, 6, 3, 3, 3, 1
10977, 13145, 1, "OK", 6, 67, 25, 16, 9, 7, 9, 1
5334, 5810, 1, "OK", 3, 13, 2, 1, 1, 0, 1, 1
10944, 13145, 1, "OK", 5, 68, 25, 16, 9, 7, 9, 1
10916, 12999, 0, "Ambiguous return value: Selected block modifies more than one local variable used in subsequent code. Affected variables are:  double fopt double[][] xLocal double[][] arrScales double[][] rotation double[] peaks", 0, 0, 25, 16, 9, 7, 9, 1
8728, 9149, 0, "Ambiguous return value: Selected block modifies more than one local variable used in subsequent code. Affected variables are:  double[][] rot1 BBOBFunction problem", 0, 0, 5, 3, 2, 1, 2, 1
10977, 12135, 0, "Ambiguous return value: Selected block modifies more than one local variable used in subsequent code. Affected variables are:  double b double c double[] xopt double fopt double[][] xLocal double[][] arrScales double[][] rotation List<Integer> rperm double[] arrCondition double[] peaks", 0, 0, 4, 2, 2, 0, 2, 1
7364, 8419, 1, "OK", 5, 28, 9, 6, 3, 3, 3, 1
7702, 8181, 1, "OK", 6, 16, 9, 6, 3, 3, 3, 1
9857, 9991, 1, "OK", 3, 7, 5, 3, 2, 1, 2, 1
6200, 6622, 1, "OK", 6, 15, 9, 6, 3, 3, 3, 1
4434, 5046, 1, "OK", 7, 19, 9, 6, 3, 3, 3, 1
5965, 6737, 1, "OK", 4, 23, 9, 6, 3, 3, 3, 1
7304, 8242, 0, "Ambiguous return value: Selected block modifies more than one local variable used in subsequent code. Affected variables are:  double[] xopt double[] zeros double[][] rot1 BBOBFunction problem", 0, 0, 9, 6, 3, 3, 3, 1
10944, 13164, 1, "OK", 5, 69, 25, 16, 9, 7, 9, 1
11803, 12135, 1, "OK", 6, 9, 2, 1, 1, 0, 1, 1
7506, 8123, 0, "Ambiguous return value: Selected block modifies more than one local variable used in subsequent code. Affected variables are:  double[][] M double[][] rot1 BBOBFunction problem", 0, 0, 9, 6, 3, 3, 3, 1
10977, 13164, 1, "OK", 6, 68, 25, 16, 9, 7, 9, 1
10944, 12135, 0, "Ambiguous return value: Selected block modifies more than one local variable used in subsequent code. Affected variables are:  double b double c double[] xopt double fopt double[][] xLocal double[][] arrScales double[][] rotation List<Integer> rperm double[] arrCondition double[] peaks", 0, 0, 4, 2, 2, 0, 2, 1
9996, 10805, 1, "OK", 7, 24, 11, 7, 4, 3, 4, 1
6004, 6565, 0, "Ambiguous return value: Selected block modifies more than one local variable used in subsequent code. Affected variables are:  double[][] M BBOBFunction problem", 0, 0, 9, 6, 3, 3, 3, 1
7364, 8438, 1, "OK", 5, 29, 9, 6, 3, 3, 3, 1
9765, 10805, 1, "OK", 5, 35, 16, 10, 6, 4, 6, 1
12186, 12556, 1, "OK", 6, 12, 6, 2, 2, 0, 2, 2
5905, 6565, 0, "Ambiguous return value: Selected block modifies more than one local variable used in subsequent code. Affected variables are:  double fopt double[] b double[][] M BBOBFunction problem", 0, 0, 9, 6, 3, 3, 3, 1
11803, 13164, 1, "OK", 15, 46, 23, 15, 8, 7, 8, 1
11451, 11799, 0, "Ambiguous return value: Selected block modifies more than one local variable used in subsequent code. Affected variables are:  List<Integer> rperm double[] arrCondition", 0, 0, 2, 1, 1, 0, 1, 1
5965, 6756, 1, "OK", 4, 24, 9, 6, 3, 3, 3, 1
5214, 5468, 0, "Ambiguous return value: Selected block modifies more than one local variable used in subsequent code. Affected variables are:  double[] xopt double fopt double[] minusOne", 0, 0, 2, 1, 1, 0, 1, 1
4501, 5046, 1, "OK", 7, 17, 9, 6, 3, 3, 3, 1
4266, 5161, 1, "OK", 4, 25, 9, 6, 3, 3, 3, 1
9681, 10358, 0, "Ambiguous return value: Selected block modifies more than one local variable used in subsequent code. Affected variables are:  double[] xopt double[] tmp2 double[] b double[][] M", 0, 0, 16, 10, 6, 4, 6, 1
7635, 8242, 1, "OK", 6, 19, 9, 6, 3, 3, 3, 1
11061, 12634, 0, "Ambiguous return value: Selected block modifies more than one local variable used in subsequent code. Affected variables are:  double[] xopt double fopt double[][] xLocal double[][] arrScales double[][] rotation double[] gallagher_peaks double[] peaks", 0, 0, 12, 7, 5, 2, 5, 1
8593, 9264, 0, "Ambiguous return value: Selected block modifies more than one local variable used in subsequent code. Affected variables are:  double[] zeros double[][] rot1 BBOBFunction problem", 0, 0, 5, 3, 2, 1, 2, 1
6133, 6680, 1, "OK", 6, 18, 9, 6, 3, 3, 3, 1
9804, 10638, 1, "OK", 6, 31, 16, 10, 6, 4, 6, 1
11887, 12634, 1, "OK", 9, 23, 10, 6, 4, 2, 4, 1
9561, 9991, 0, "Ambiguous return value: Selected block modifies more than one local variable used in subsequent code. Affected variables are:  double[] tmp1 double fopt double[] xopt double[] tmp2 double[] b double[][] M", 0, 0, 5, 3, 2, 1, 2, 1
12566, 13088, 1, "OK", 10, 19, 13, 9, 4, 5, 4, 1
4305, 4989, 0, "Ambiguous return value: Selected block modifies more than one local variable used in subsequent code. Affected variables are:  double[][] M BBOBFunction problem", 0, 0, 9, 6, 3, 3, 3, 1
10241, 10410, 1, "OK", 4, 6, 2, 1, 1, 0, 1, 1
11022, 11799, 0, "Ambiguous return value: Selected block modifies more than one local variable used in subsequent code. Affected variables are:  double b double c double[] fitvalues double[] xopt double fopt double[][] xLocal double[][] arrScales double[][] rotation List<Integer> rperm double[] arrCondition", 0, 0, 2, 1, 1, 0, 1, 1
8533, 9096, 0, "Ambiguous return value: Selected block modifies more than one local variable used in subsequent code. Affected variables are:  double fopt double[] zeros double[] b double[][] M double[][] rot1", 0, 0, 5, 3, 2, 1, 2, 1
4266, 5180, 1, "OK", 4, 26, 9, 6, 3, 3, 3, 1
11262, 12561, 0, "Ambiguous return value: Selected block modifies more than one local variable used in subsequent code. Affected variables are:  double[][] arrScales double[][] rotation double[] peaks", 0, 0, 12, 7, 5, 2, 5, 1
4206, 4989, 0, "Ambiguous return value: Selected block modifies more than one local variable used in subsequent code. Affected variables are:  double fopt double[] b double[][] M BBOBFunction problem", 0, 0, 9, 6, 3, 3, 3, 1
11524, 12634, 0, "Ambiguous return value: Selected block modifies more than one local variable used in subsequent code. Affected variables are:  double[] gallagher_peaks double[] peaks", 0, 0, 12, 7, 5, 2, 5, 1
5274, 5677, 0, "Ambiguous return value: Selected block modifies more than one local variable used in subsequent code. Affected variables are:  double fopt BBOBFunction problem", 0, 0, 2, 1, 1, 0, 1, 1
11326, 12634, 0, "Ambiguous return value: Selected block modifies more than one local variable used in subsequent code. Affected variables are:  double[][] rotation double[] gallagher_peaks double[] peaks", 0, 0, 12, 7, 5, 2, 5, 1
4146, 4812, 0, "Ambiguous return value: Selected block modifies more than one local variable used in subsequent code. Affected variables are:  double[] xopt double fopt double[] b double[][] M", 0, 0, 9, 6, 3, 3, 3, 1
12140, 12999, 1, "OK", 11, 32, 21, 14, 7, 7, 7, 1
11906, 13088, 1, "OK", 14, 39, 23, 15, 8, 7, 8, 1
8728, 9206, 0, "Ambiguous return value: Selected block modifies more than one local variable used in subsequent code. Affected variables are:  double[][] rot1 BBOBFunction problem", 0, 0, 5, 3, 2, 1, 2, 1
4434, 5104, 1, "OK", 7, 20, 9, 6, 3, 3, 3, 1
7702, 8242, 1, "OK", 6, 17, 9, 6, 3, 3, 3, 1
7304, 8297, 0, "Ambiguous return value: Selected block modifies more than one local variable used in subsequent code. Affected variables are:  double[] xopt double[] zeros double[][] rot1 BBOBFunction problem", 0, 0, 9, 6, 3, 3, 3, 1
6200, 6680, 1, "OK", 6, 16, 9, 6, 3, 3, 3, 1
7467, 8362, 1, "OK", 4, 25, 9, 6, 3, 3, 3, 1
11061, 11642, 0, "Ambiguous return value: Selected block modifies more than one local variable used in subsequent code. Affected variables are:  double[] fitvalues double[] xopt double fopt double[][] xLocal double[][] arrScales double[][] rotation double[] gallagher_peaks List<Integer> rperm", 0, 0, 2, 1, 1, 0, 1, 1
11451, 11835, 0, "Ambiguous return value: Selected block modifies more than one local variable used in subsequent code. Affected variables are:  List<Integer> rperm double[] arrCondition", 0, 0, 2, 1, 1, 0, 1, 1
11840, 13088, 1, "OK", 13, 42, 23, 15, 8, 7, 8, 1
8930, 9091, 1, "OK", 4, 4, 3, 1, 1, 0, 1, 2
7506, 8181, 0, "Ambiguous return value: Selected block modifies more than one local variable used in subsequent code. Affected variables are:  double[][] rot1 BBOBFunction problem", 0, 0, 9, 6, 3, 3, 3, 1
9996, 10862, 1, "OK", 8, 25, 11, 7, 4, 3, 4, 1
6004, 6622, 0, "Ambiguous return value: Selected block modifies more than one local variable used in subsequent code. Affected variables are:  double[][] M BBOBFunction problem", 0, 0, 9, 6, 3, 3, 3, 1
4543, 4807, 1, "OK", 6, 10, 7, 3, 2, 1, 2, 2
11022, 11835, 0, "Ambiguous return value: Selected block modifies more than one local variable used in subsequent code. Affected variables are:  double b double c double[] fitvalues double[] xopt double fopt double[][] xLocal double[][] arrScales double[][] rotation List<Integer> rperm double[] arrCondition", 0, 0, 2, 1, 1, 0, 1, 1
5905, 6622, 0, "Ambiguous return value: Selected block modifies more than one local variable used in subsequent code. Affected variables are:  double[] b double[][] M BBOBFunction problem", 0, 0, 9, 6, 3, 3, 3, 1
11576, 13088, 1, "OK", 14, 52, 25, 16, 9, 7, 9, 1
9765, 10862, 1, "OK", 6, 36, 16, 10, 6, 4, 6, 1
9996, 10881, 1, "OK", 8, 26, 11, 7, 4, 3, 4, 1
11524, 11642, 1, "OK", 1, 5, 2, 1, 1, 0, 1, 1
7635, 8297, 1, "OK", 6, 20, 9, 6, 3, 3, 3, 1
5214, 5522, 0, "Ambiguous return value: Selected block modifies more than one local variable used in subsequent code. Affected variables are:  double[] xopt double fopt double[] minusOne BBOBFunction problem", 0, 0, 2, 1, 1, 0, 1, 1
9804, 10695, 1, "OK", 6, 32, 16, 10, 6, 4, 6, 1
10916, 13088, 0, "Ambiguous return value: Selected block modifies more than one local variable used in subsequent code. Affected variables are:  double fopt BBOBFunction problem", 0, 0, 25, 16, 9, 7, 9, 1
11326, 11642, 0, "Ambiguous return value: Selected block modifies more than one local variable used in subsequent code. Affected variables are:  double[][] rotation double[] gallagher_peaks List<Integer> rperm", 0, 0, 2, 1, 1, 0, 1, 1
8593, 9325, 0, "Ambiguous return value: Selected block modifies more than one local variable used in subsequent code. Affected variables are:  double[] zeros double[][] rot1 BBOBFunction problem", 0, 0, 5, 3, 2, 1, 2, 1
9765, 10881, 1, "OK", 6, 37, 16, 10, 6, 4, 6, 1
5381, 5468, 1, "OK", 3, 4, 2, 1, 1, 0, 1, 1
4501, 5104, 1, "OK", 7, 18, 9, 6, 3, 3, 3, 1
6133, 6737, 1, "OK", 7, 19, 9, 6, 3, 3, 3, 1
9681, 10410, 0, "Ambiguous return value: Selected block modifies more than one local variable used in subsequent code. Affected variables are:  double[] xopt double[] tmp2 double[] b double[][] M BBOBFunction problem", 0, 0, 16, 10, 6, 4, 6, 1
12566, 13145, 1, "OK", 11, 20, 13, 9, 4, 5, 4, 1
4305, 5046, 0, "Ambiguous return value: Selected block modifies more than one local variable used in subsequent code. Affected variables are:  double[][] M BBOBFunction problem", 0, 0, 9, 6, 3, 3, 3, 1
10241, 10467, 1, "OK", 5, 7, 2, 1, 1, 0, 1, 1
7744, 8008, 1, "OK", 6, 10, 7, 3, 2, 1, 2, 2
4206, 5046, 0, "Ambiguous return value: Selected block modifies more than one local variable used in subsequent code. Affected variables are:  double[] b double[][] M BBOBFunction problem", 0, 0, 9, 6, 3, 3, 3, 1
9621, 10236, 0, "Ambiguous return value: Selected block modifies more than one local variable used in subsequent code. Affected variables are:  double fopt double[] xopt double[] tmp2 double[] b double[][] M", 0, 0, 14, 9, 5, 4, 5, 1
8533, 9149, 0, "Ambiguous return value: Selected block modifies more than one local variable used in subsequent code. Affected variables are:  double fopt double[] zeros double[] b double[][] M double[][] rot1 BBOBFunction problem", 0, 0, 5, 3, 2, 1, 2, 1
5274, 5734, 0, "Ambiguous return value: Selected block modifies more than one local variable used in subsequent code. Affected variables are:  double fopt BBOBFunction problem", 0, 0, 2, 1, 1, 0, 1, 1
12566, 13164, 1, "OK", 11, 21, 13, 9, 4, 5, 4, 1
11099, 12561, 0, "Ambiguous return value: Selected block modifies more than one local variable used in subsequent code. Affected variables are:  double[] xopt double fopt double[][] xLocal double[][] arrScales double[][] rotation double[] peaks", 0, 0, 12, 7, 5, 2, 5, 1
6133, 6756, 1, "OK", 7, 20, 9, 6, 3, 3, 3, 1
11451, 11883, 0, "Ambiguous return value: Selected block modifies more than one local variable used in subsequent code. Affected variables are:  List<Integer> rperm double[] arrCondition double[] peaks", 0, 0, 2, 1, 1, 0, 1, 1
7702, 8297, 1, "OK", 6, 18, 9, 6, 3, 3, 3, 1
11262, 12634, 0, "Ambiguous return value: Selected block modifies more than one local variable used in subsequent code. Affected variables are:  double[][] arrScales double[][] rotation double[] gallagher_peaks double[] peaks", 0, 0, 12, 7, 5, 2, 5, 1
6200, 6737, 1, "OK", 7, 17, 9, 6, 3, 3, 3, 1
4434, 5161, 1, "OK", 7, 21, 9, 6, 3, 3, 3, 1
7467, 8419, 1, "OK", 5, 26, 9, 6, 3, 3, 3, 1
11022, 11883, 0, "Ambiguous return value: Selected block modifies more than one local variable used in subsequent code. Affected variables are:  double b double c double[] fitvalues double[] xopt double fopt double[][] xLocal double[][] arrScales double[][] rotation List<Integer> rperm double[] arrCondition double[] peaks", 0, 0, 2, 1, 1, 0, 1, 1
8728, 9264, 0, "Ambiguous return value: Selected block modifies more than one local variable used in subsequent code. Affected variables are:  double[][] rot1 BBOBFunction problem", 0, 0, 5, 3, 2, 1, 2, 1
11906, 13145, 1, "OK", 15, 40, 23, 15, 8, 7, 8, 1
4146, 4878, 0, "Ambiguous return value: Selected block modifies more than one local variable used in subsequent code. Affected variables are:  double[] xopt double fopt double[] b double[][] M BBOBFunction problem", 0, 0, 9, 6, 3, 3, 3, 1
11840, 13145, 1, "OK", 14, 43, 23, 15, 8, 7, 8, 1
7304, 8362, 0, "Ambiguous return value: Selected block modifies more than one local variable used in subsequent code. Affected variables are:  double[] xopt BBOBFunction problem", 0, 0, 9, 6, 3, 3, 3, 1
7506, 8242, 0, "Ambiguous return value: Selected block modifies more than one local variable used in subsequent code. Affected variables are:  double[][] rot1 BBOBFunction problem", 0, 0, 9, 6, 3, 3, 3, 1
11906, 12135, 1, "OK", 6, 4, 2, 1, 1, 0, 1, 1
12805, 12934, 1, "OK", 8, 3, 4, 1, 1, 0, 1, 3
11451, 11901, 0, "Ambiguous return value: Selected block modifies more than one local variable used in subsequent code. Affected variables are:  List<Integer> rperm double[] arrCondition double[] peaks", 0, 0, 2, 1, 1, 0, 1, 1
6004, 6680, 1, "OK", 4, 21, 9, 6, 3, 3, 3, 1
11576, 13145, 1, "OK", 15, 53, 25, 16, 9, 7, 9, 1
11840, 13164, 1, "OK", 14, 44, 23, 15, 8, 7, 8, 1
4434, 5180, 1, "OK", 7, 22, 9, 6, 3, 3, 3, 1
5905, 6680, 1, "OK", 4, 23, 9, 6, 3, 3, 3, 1
5381, 5522, 1, "OK", 3, 6, 2, 1, 1, 0, 1, 1
11647, 12999, 1, "OK", 14, 46, 23, 15, 8, 7, 8, 1
11840, 12135, 1, "OK", 5, 7, 2, 1, 1, 0, 1, 1
6200, 6756, 1, "OK", 7, 18, 9, 6, 3, 3, 3, 1
11906, 13164, 1, "OK", 15, 41, 23, 15, 8, 7, 8, 1
7467, 8438, 1, "OK", 5, 27, 9, 6, 3, 3, 3, 1
5214, 5583, 0, "Ambiguous return value: Selected block modifies more than one local variable used in subsequent code. Affected variables are:  double[] xopt double fopt BBOBFunction problem", 0, 0, 2, 1, 1, 0, 1, 1
7279, 13249, 1, "OK", 4, 174, 60, 60, 25, 35, 20, 0
9804, 10751, 1, "OK", 6, 33, 16, 10, 6, 4, 6, 1
11576, 13164, 1, "OK", 15, 54, 25, 16, 9, 7, 9, 1
12140, 13088, 1, "OK", 12, 34, 21, 14, 7, 7, 7, 1
10916, 13145, 1, "OK", 4, 69, 25, 16, 9, 7, 9, 1
11022, 11901, 0, "Ambiguous return value: Selected block modifies more than one local variable used in subsequent code. Affected variables are:  double b double c double[] fitvalues double[] xopt double fopt double[][] xLocal double[][] arrScales double[][] rotation List<Integer> rperm double[] arrCondition double[] peaks", 0, 0, 2, 1, 1, 0, 1, 1
11061, 11716, 0, "Ambiguous return value: Selected block modifies more than one local variable used in subsequent code. Affected variables are:  double[] fitvalues double[] xopt double fopt double[][] xLocal double[][] arrScales double[][] rotation List<Integer> rperm", 0, 0, 2, 1, 1, 0, 1, 1
11576, 12135, 0, "Ambiguous return value: Selected block modifies more than one local variable used in subsequent code. Affected variables are:  double[] arrCondition double[] peaks", 0, 0, 4, 2, 2, 0, 2, 1
4501, 5161, 1, "OK", 7, 19, 9, 6, 3, 3, 3, 1
9681, 10467, 0, "Ambiguous return value: Selected block modifies more than one local variable used in subsequent code. Affected variables are:  double[] xopt double[] tmp2 double[] b double[][] M BBOBFunction problem", 0, 0, 16, 10, 6, 4, 6, 1
11262, 11642, 0, "Ambiguous return value: Selected block modifies more than one local variable used in subsequent code. Affected variables are:  double[][] arrScales double[][] rotation double[] gallagher_peaks List<Integer> rperm", 0, 0, 2, 1, 1, 0, 1, 1
5845, 6511, 0, "Ambiguous return value: Selected block modifies more than one local variable used in subsequent code. Affected variables are:  double[] xopt double fopt double[] b double[][] M", 0, 0, 9, 6, 3, 3, 3, 1
8593, 9390, 1, "OK", 3, 21, 5, 3, 2, 1, 2, 1
7635, 8362, 1, "OK", 7, 21, 9, 6, 3, 3, 3, 1
10241, 10523, 1, "OK", 5, 8, 2, 1, 1, 0, 1, 1
4206, 5104, 1, "OK", 5, 25, 9, 6, 3, 3, 3, 1
10916, 12135, 0, "Ambiguous return value: Selected block modifies more than one local variable used in subsequent code. Affected variables are:  int numberOfPeaks double b double c double[] xopt double fopt double[][] xLocal double[][] arrScales double[][] rotation List<Integer> rperm double[] arrCondition double[] peaks", 0, 0, 4, 2, 2, 0, 2, 1
4305, 5104, 1, "OK", 5, 23, 9, 6, 3, 3, 3, 1
11326, 11716, 0, "Ambiguous return value: Selected block modifies more than one local variable used in subsequent code. Affected variables are:  double[][] rotation List<Integer> rperm", 0, 0, 2, 1, 1, 0, 1, 1
5274, 5791, 1, "OK", 4, 13, 2, 1, 1, 0, 1, 1
11524, 11716, 1, "OK", 2, 7, 2, 1, 1, 0, 1, 1
8533, 9206, 0, "Ambiguous return value: Selected block modifies more than one local variable used in subsequent code. Affected variables are:  double[] zeros double[] b double[][] M double[][] rot1 BBOBFunction problem", 0, 0, 5, 3, 2, 1, 2, 1
8636, 9096, 0, "Ambiguous return value: Selected block modifies more than one local variable used in subsequent code. Affected variables are:  double[] b double[][] M double[][] rot1", 0, 0, 5, 3, 2, 1, 2, 1
4501, 5180, 1, "OK", 7, 20, 9, 6, 3, 3, 3, 1
6242, 6506, 1, "OK", 6, 10, 7, 3, 2, 1, 2, 2
10916, 13164, 1, "OK", 4, 70, 25, 16, 9, 7, 9, 1
12639, 12999, 1, "OK", 8, 15, 13, 9, 4, 5, 4, 1
8728, 9325, 0, "Ambiguous return value: Selected block modifies more than one local variable used in subsequent code. Affected variables are:  double[][] rot1 BBOBFunction problem", 0, 0, 5, 3, 2, 1, 2, 1
4146, 4933, 0, "Ambiguous return value: Selected block modifies more than one local variable used in subsequent code. Affected variables are:  double[] xopt double fopt double[] b double[][] M BBOBFunction problem", 0, 0, 9, 6, 3, 3, 3, 1
7702, 8362, 1, "OK", 7, 19, 9, 6, 3, 3, 3, 1
5274, 5810, 1, "OK", 4, 14, 2, 1, 1, 0, 1, 1
7506, 8297, 0, "Ambiguous return value: Selected block modifies more than one local variable used in subsequent code. Affected variables are:  double[][] rot1 BBOBFunction problem", 0, 0, 9, 6, 3, 3, 3, 1
6004, 6737, 1, "OK", 5, 22, 9, 6, 3, 3, 3, 1
12805, 12988, 1, "OK", 8, 7, 8, 2, 2, 0, 2, 3
7304, 8419, 1, "OK", 4, 29, 9, 6, 3, 3, 3, 1
12423, 12556, 1, "OK", 5, 3, 3, 1, 1, 0, 1, 2
5905, 6737, 1, "OK", 5, 24, 9, 6, 3, 3, 3, 1
11099, 12634, 0, "Ambiguous return value: Selected block modifies more than one local variable used in subsequent code. Affected variables are:  double[] xopt double fopt double[][] xLocal double[][] arrScales double[][] rotation double[] gallagher_peaks double[] peaks", 0, 0, 12, 7, 5, 2, 5, 1
9723, 10236, 0, "Ambiguous return value: Selected block modifies more than one local variable used in subsequent code. Affected variables are:  double[] tmp2 double[] b double[][] M", 0, 0, 14, 9, 5, 4, 5, 1
11451, 12999, 1, "OK", 12, 53, 25, 16, 9, 7, 9, 1
5381, 5583, 1, "OK", 3, 7, 2, 1, 1, 0, 1, 1
12140, 13145, 1, "OK", 13, 35, 21, 14, 7, 7, 7, 1
7304, 8438, 1, "OK", 4, 30, 9, 6, 3, 3, 3, 1
9804, 10805, 1, "OK", 6, 34, 16, 10, 6, 4, 6, 1
9681, 10523, 0, "Ambiguous return value: Selected block modifies more than one local variable used in subsequent code. Affected variables are:  double[] xopt double[] tmp2 double[] b double[][] M BBOBFunction problem", 0, 0, 16, 10, 6, 4, 6, 1
10241, 10580, 1, "OK", 5, 9, 2, 1, 1, 0, 1, 1
7635, 8419, 1, "OK", 8, 22, 9, 6, 3, 3, 3, 1
5845, 6565, 0, "Ambiguous return value: Selected block modifies more than one local variable used in subsequent code. Affected variables are:  double[] xopt double fopt double[] b double[][] M BBOBFunction problem", 0, 0, 9, 6, 3, 3, 3, 1
6004, 6756, 1, "OK", 5, 23, 9, 6, 3, 3, 3, 1
8593, 9447, 1, "OK", 4, 22, 5, 3, 2, 1, 2, 1
11201, 12561, 0, "Ambiguous return value: Selected block modifies more than one local variable used in subsequent code. Affected variables are:  double[][] xLocal double[][] arrScales double[][] rotation double[] peaks", 0, 0, 12, 7, 5, 2, 5, 1
5905, 6756, 1, "OK", 5, 25, 9, 6, 3, 3, 3, 1
8533, 9264, 0, "Ambiguous return value: Selected block modifies more than one local variable used in subsequent code. Affected variables are:  double[] zeros double[][] rot1 BBOBFunction problem", 0, 0, 5, 3, 2, 1, 2, 1
4305, 5161, 1, "OK", 5, 24, 9, 6, 3, 3, 3, 1
4206, 5161, 1, "OK", 5, 26, 9, 6, 3, 3, 3, 1
11022, 12999, 0, "Ambiguous return value: Selected block modifies more than one local variable used in subsequent code. Affected variables are:  double fopt double[][] xLocal double[][] arrScales double[][] rotation double[] peaks", 0, 0, 25, 16, 9, 7, 9, 1
11262, 11716, 0, "Ambiguous return value: Selected block modifies more than one local variable used in subsequent code. Affected variables are:  double[][] arrScales double[][] rotation List<Integer> rperm", 0, 0, 2, 1, 1, 0, 1, 1
12140, 13164, 1, "OK", 13, 36, 21, 14, 7, 7, 7, 1
11099, 11642, 0, "Ambiguous return value: Selected block modifies more than one local variable used in subsequent code. Affected variables are:  double[] xopt double fopt double[][] xLocal double[][] arrScales double[][] rotation double[] gallagher_peaks List<Integer> rperm", 0, 0, 2, 1, 1, 0, 1, 1
8636, 9149, 0, "Ambiguous return value: Selected block modifies more than one local variable used in subsequent code. Affected variables are:  double[] b double[][] M double[][] rot1 BBOBFunction problem", 0, 0, 5, 3, 2, 1, 2, 1
9621, 10358, 0, "Ambiguous return value: Selected block modifies more than one local variable used in subsequent code. Affected variables are:  double fopt double[] xopt double[] tmp2 double[] b double[][] M", 0, 0, 16, 10, 6, 4, 6, 1
11061, 11799, 0, "Ambiguous return value: Selected block modifies more than one local variable used in subsequent code. Affected variables are:  double[] fitvalues double[] xopt double fopt double[][] xLocal double[][] arrScales double[][] rotation List<Integer> rperm double[] arrCondition", 0, 0, 2, 1, 1, 0, 1, 1
11749, 12999, 1, "OK", 13, 43, 23, 15, 8, 7, 8, 1
7635, 8438, 1, "OK", 8, 23, 9, 6, 3, 3, 3, 1
9765, 9991, 0, "Ambiguous return value: Selected block modifies more than one local variable used in subsequent code. Affected variables are:  double[] b double[][] M", 0, 0, 5, 3, 2, 1, 2, 1
11647, 13088, 1, "OK", 14, 48, 23, 15, 8, 7, 8, 1
4206, 5180, 1, "OK", 5, 27, 9, 6, 3, 3, 3, 1
7702, 8419, 1, "OK", 8, 20, 9, 6, 3, 3, 3, 1
4146, 4989, 0, "Ambiguous return value: Selected block modifies more than one local variable used in subsequent code. Affected variables are:  double[] xopt double fopt double[] b double[][] M BBOBFunction problem", 0, 0, 9, 6, 3, 3, 3, 1
4305, 5180, 1, "OK", 5, 25, 9, 6, 3, 3, 3, 1
11524, 11799, 0, "Ambiguous return value: Selected block modifies more than one local variable used in subsequent code. Affected variables are:  List<Integer> rperm double[] arrCondition", 0, 0, 2, 1, 1, 0, 1, 1
5214, 5677, 0, "Ambiguous return value: Selected block modifies more than one local variable used in subsequent code. Affected variables are:  double[] xopt double fopt BBOBFunction problem", 0, 0, 2, 1, 1, 0, 1, 1
8728, 9390, 1, "OK", 6, 17, 5, 3, 2, 1, 2, 1
8473, 9096, 0, "Ambiguous return value: Selected block modifies more than one local variable used in subsequent code. Affected variables are:  double[] xopt double fopt double[] zeros double[] b double[][] M double[][] rot1", 0, 0, 5, 3, 2, 1, 2, 1
10055, 10231, 1, "OK", 3, 6, 7, 3, 2, 1, 2, 2
9857, 10236, 1, "OK", 5, 18, 14, 9, 5, 4, 5, 1
7506, 8362, 1, "OK", 5, 24, 9, 6, 3, 3, 3, 1
11326, 11799, 0, "Ambiguous return value: Selected block modifies more than one local variable used in subsequent code. Affected variables are:  double[][] rotation List<Integer> rperm double[] arrCondition", 0, 0, 2, 1, 1, 0, 1, 1
9681, 10580, 0, "Ambiguous return value: Selected block modifies more than one local variable used in subsequent code. Affected variables are:  double[] xopt double[] tmp2 double[] b double[][] M BBOBFunction problem", 0, 0, 16, 10, 6, 4, 6, 1
8804, 9096, 1, "OK", 4, 10, 5, 3, 2, 1, 2, 1
7702, 8438, 1, "OK", 8, 21, 9, 6, 3, 3, 3, 1
11061, 11835, 0, "Ambiguous return value: Selected block modifies more than one local variable used in subsequent code. Affected variables are:  double[] fitvalues double[] xopt double fopt double[][] xLocal double[][] arrScales double[][] rotation List<Integer> rperm double[] arrCondition", 0, 0, 2, 1, 1, 0, 1, 1
12639, 13088, 1, "OK", 10, 17, 13, 9, 4, 5, 4, 1
9804, 10862, 1, "OK", 7, 35, 16, 10, 6, 4, 6, 1
5845, 6622, 0, "Ambiguous return value: Selected block modifies more than one local variable used in subsequent code. Affected variables are:  double[] xopt double[] b double[][] M BBOBFunction problem", 0, 0, 9, 6, 3, 3, 3, 1
10241, 10638, 1, "OK", 7, 10, 2, 1, 1, 0, 1, 1
9621, 10410, 0, "Ambiguous return value: Selected block modifies more than one local variable used in subsequent code. Affected variables are:  double fopt double[] xopt double[] tmp2 double[] b double[][] M BBOBFunction problem", 0, 0, 16, 10, 6, 4, 6, 1
9804, 10881, 1, "OK", 7, 36, 16, 10, 6, 4, 6, 1
8593, 9507, 1, "OK", 4, 23, 5, 3, 2, 1, 2, 1
11326, 11835, 0, "Ambiguous return value: Selected block modifies more than one local variable used in subsequent code. Affected variables are:  double[][] rotation List<Integer> rperm double[] arrCondition", 0, 0, 2, 1, 1, 0, 1, 1
9899, 9986, 1, "OK", 3, 5, 3, 1, 1, 0, 1, 2
8533, 9325, 0, "Ambiguous return value: Selected block modifies more than one local variable used in subsequent code. Affected variables are:  double[] zeros double[][] rot1 BBOBFunction problem", 0, 0, 5, 3, 2, 1, 2, 1
11524, 11835, 0, "Ambiguous return value: Selected block modifies more than one local variable used in subsequent code. Affected variables are:  List<Integer> rperm double[] arrCondition", 0, 0, 2, 1, 1, 0, 1, 1
11647, 13145, 1, "OK", 15, 49, 23, 15, 8, 7, 8, 1
8636, 9206, 0, "Ambiguous return value: Selected block modifies more than one local variable used in subsequent code. Affected variables are:  double[] b double[][] M double[][] rot1 BBOBFunction problem", 0, 0, 5, 3, 2, 1, 2, 1
11201, 12634, 0, "Ambiguous return value: Selected block modifies more than one local variable used in subsequent code. Affected variables are:  double[][] xLocal double[][] arrScales double[][] rotation double[] gallagher_peaks double[] peaks", 0, 0, 12, 7, 5, 2, 5, 1
9561, 10236, 0, "Ambiguous return value: Selected block modifies more than one local variable used in subsequent code. Affected variables are:  double[] tmp1 double fopt double[] xopt double[] tmp2 double[] b double[][] M", 0, 0, 14, 9, 5, 4, 5, 1
8473, 9149, 0, "Ambiguous return value: Selected block modifies more than one local variable used in subsequent code. Affected variables are:  double[] xopt double fopt double[] zeros double[] b double[][] M double[][] rot1 BBOBFunction problem", 0, 0, 5, 3, 2, 1, 2, 1
8593, 9526, 1, "OK", 4, 24, 5, 3, 2, 1, 2, 1
11451, 13088, 1, "OK", 12, 55, 25, 16, 9, 7, 9, 1
8871, 9096, 1, "OK", 4, 8, 5, 3, 2, 1, 2, 1
4146, 5046, 0, "Ambiguous return value: Selected block modifies more than one local variable used in subsequent code. Affected variables are:  double[] xopt double[] b double[][] M BBOBFunction problem", 0, 0, 9, 6, 3, 3, 3, 1
5214, 5734, 0, "Ambiguous return value: Selected block modifies more than one local variable used in subsequent code. Affected variables are:  double fopt BBOBFunction problem", 0, 0, 2, 1, 1, 0, 1, 1
5381, 5677, 1, "OK", 3, 8, 2, 1, 1, 0, 1, 1
11647, 13164, 1, "OK", 15, 50, 23, 15, 8, 7, 8, 1
11647, 12135, 0, "Ambiguous return value: Selected block modifies more than one local variable used in subsequent code. Affected variables are:  double[] arrCondition double[] peaks", 0, 0, 2, 1, 1, 0, 1, 1
11099, 11716, 0, "Ambiguous return value: Selected block modifies more than one local variable used in subsequent code. Affected variables are:  double[] xopt double fopt double[][] xLocal double[][] arrScales double[][] rotation List<Integer> rperm", 0, 0, 2, 1, 1, 0, 1, 1
7506, 8419, 1, "OK", 6, 25, 9, 6, 3, 3, 3, 1
11061, 11883, 0, "Ambiguous return value: Selected block modifies more than one local variable used in subsequent code. Affected variables are:  double[] fitvalues double[] xopt double fopt double[][] xLocal double[][] arrScales double[][] rotation List<Integer> rperm double[] arrCondition double[] peaks", 0, 0, 2, 1, 1, 0, 1, 1
8728, 9447, 1, "OK", 7, 18, 5, 3, 2, 1, 2, 1
11022, 13088, 0, "Ambiguous return value: Selected block modifies more than one local variable used in subsequent code. Affected variables are:  double fopt BBOBFunction problem", 0, 0, 25, 16, 9, 7, 9, 1
12941, 12988, 1, "OK", 3, 3, 4, 1, 1, 0, 1, 3
9723, 10358, 0, "Ambiguous return value: Selected block modifies more than one local variable used in subsequent code. Affected variables are:  double[] tmp2 double[] b double[][] M", 0, 0, 16, 10, 6, 4, 6, 1
11749, 13088, 1, "OK", 13, 45, 23, 15, 8, 7, 8, 1
9681, 10638, 0, "Ambiguous return value: Selected block modifies more than one local variable used in subsequent code. Affected variables are:  double[] xopt double[] tmp2 BBOBFunction problem", 0, 0, 16, 10, 6, 4, 6, 1
12639, 13145, 1, "OK", 11, 18, 13, 9, 4, 5, 4, 1
8804, 9149, 1, "OK", 4, 12, 5, 3, 2, 1, 2, 1
11201, 11642, 0, "Ambiguous return value: Selected block modifies more than one local variable used in subsequent code. Affected variables are:  double[][] xLocal double[][] arrScales double[][] rotation double[] gallagher_peaks List<Integer> rperm", 0, 0, 2, 1, 1, 0, 1, 1
11262, 11799, 0, "Ambiguous return value: Selected block modifies more than one local variable used in subsequent code. Affected variables are:  double[][] arrScales double[][] rotation List<Integer> rperm double[] arrCondition", 0, 0, 2, 1, 1, 0, 1, 1
10241, 10695, 1, "OK", 7, 11, 2, 1, 1, 0, 1, 1
5845, 6680, 0, "Ambiguous return value: Selected block modifies more than one local variable used in subsequent code. Affected variables are:  double[] xopt BBOBFunction problem", 0, 0, 9, 6, 3, 3, 3, 1
7506, 8438, 1, "OK", 6, 26, 9, 6, 3, 3, 3, 1
12639, 13164, 1, "OK", 11, 19, 13, 9, 4, 5, 4, 1
3354, 13249, 1, "OK", 3, 276, 86, 86, 38, 48, 27, 0
9621, 10467, 0, "Ambiguous return value: Selected block modifies more than one local variable used in subsequent code. Affected variables are:  double[] xopt double[] tmp2 double[] b double[][] M BBOBFunction problem", 0, 0, 16, 10, 6, 4, 6, 1
11326, 11883, 0, "Ambiguous return value: Selected block modifies more than one local variable used in subsequent code. Affected variables are:  double[][] rotation List<Integer> rperm double[] arrCondition double[] peaks", 0, 0, 2, 1, 1, 0, 1, 1
11061, 11901, 0, "Ambiguous return value: Selected block modifies more than one local variable used in subsequent code. Affected variables are:  double[] fitvalues double[] xopt double fopt double[][] xLocal double[][] arrScales double[][] rotation List<Integer> rperm double[] arrCondition double[] peaks", 0, 0, 2, 1, 1, 0, 1, 1
11524, 11883, 0, "Ambiguous return value: Selected block modifies more than one local variable used in subsequent code. Affected variables are:  List<Integer> rperm double[] arrCondition double[] peaks", 0, 0, 2, 1, 1, 0, 1, 1
8636, 9264, 0, "Ambiguous return value: Selected block modifies more than one local variable used in subsequent code. Affected variables are:  double[][] rot1 BBOBFunction problem", 0, 0, 5, 3, 2, 1, 2, 1
9934, 9986, 1, "OK", 3, 3, 3, 1, 1, 0, 1, 2
8871, 9149, 1, "OK", 4, 10, 5, 3, 2, 1, 2, 1
8473, 9206, 0, "Ambiguous return value: Selected block modifies more than one local variable used in subsequent code. Affected variables are:  double[] xopt double[] zeros double[] b double[][] M double[][] rot1 BBOBFunction problem", 0, 0, 5, 3, 2, 1, 2, 1
11451, 13145, 1, "OK", 13, 56, 25, 16, 9, 7, 9, 1
12779, 12934, 1, "OK", 8, 5, 4, 1, 1, 0, 1, 3
11262, 11835, 0, "Ambiguous return value: Selected block modifies more than one local variable used in subsequent code. Affected variables are:  double[][] arrScales double[][] rotation List<Integer> rperm double[] arrCondition", 0, 0, 2, 1, 1, 0, 1, 1
4146, 5104, 0, "Ambiguous return value: Selected block modifies more than one local variable used in subsequent code. Affected variables are:  double[] xopt BBOBFunction problem", 0, 0, 9, 6, 3, 3, 3, 1
8533, 9390, 1, "OK", 4, 22, 5, 3, 2, 1, 2, 1
11524, 11901, 0, "Ambiguous return value: Selected block modifies more than one local variable used in subsequent code. Affected variables are:  List<Integer> rperm double[] arrCondition double[] peaks", 0, 0, 2, 1, 1, 0, 1, 1
5214, 5791, 1, "OK", 4, 14, 2, 1, 1, 0, 1, 1
5381, 5734, 1, "OK", 3, 9, 2, 1, 1, 0, 1, 1
8675, 9096, 0, "Ambiguous return value: Selected block modifies more than one local variable used in subsequent code. Affected variables are:  double[][] M double[][] rot1", 0, 0, 5, 3, 2, 1, 2, 1
11326, 11901, 0, "Ambiguous return value: Selected block modifies more than one local variable used in subsequent code. Affected variables are:  double[][] rotation List<Integer> rperm double[] arrCondition double[] peaks", 0, 0, 2, 1, 1, 0, 1, 1
8728, 9507, 1, "OK", 7, 19, 5, 3, 2, 1, 2, 1
11451, 12135, 0, "Ambiguous return value: Selected block modifies more than one local variable used in subsequent code. Affected variables are:  List<Integer> rperm double[] arrCondition double[] peaks", 0, 0, 4, 2, 2, 0, 2, 1
11022, 13145, 1, "OK", 7, 66, 25, 16, 9, 7, 9, 1
11749, 13145, 1, "OK", 14, 46, 23, 15, 8, 7, 8, 1
9857, 10358, 1, "OK", 6, 23, 16, 10, 6, 4, 6, 1
9681, 10695, 0, "Ambiguous return value: Selected block modifies more than one local variable used in subsequent code. Affected variables are:  double[] xopt BBOBFunction problem", 0, 0, 16, 10, 6, 4, 6, 1
9723, 10410, 0, "Ambiguous return value: Selected block modifies more than one local variable used in subsequent code. Affected variables are:  double[] tmp2 double[] b double[][] M BBOBFunction problem", 0, 0, 16, 10, 6, 4, 6, 1
5214, 5810, 1, "OK", 4, 15, 2, 1, 1, 0, 1, 1
8804, 9206, 1, "OK", 5, 13, 5, 3, 2, 1, 2, 1
11451, 13164, 1, "OK", 13, 57, 25, 16, 9, 7, 9, 1
11099, 11799, 0, "Ambiguous return value: Selected block modifies more than one local variable used in subsequent code. Affected variables are:  double[] xopt double fopt double[][] xLocal double[][] arrScales double[][] rotation List<Integer> rperm double[] arrCondition", 0, 0, 2, 1, 1, 0, 1, 1
10241, 10751, 1, "OK", 7, 12, 2, 1, 1, 0, 1, 1
11022, 13164, 1, "OK", 7, 67, 25, 16, 9, 7, 9, 1
8728, 9526, 1, "OK", 7, 20, 5, 3, 2, 1, 2, 1
5845, 6737, 1, "OK", 4, 25, 9, 6, 3, 3, 3, 1
11022, 12135, 0, "Ambiguous return value: Selected block modifies more than one local variable used in subsequent code. Affected variables are:  double b double c double[] xopt double fopt double[][] xLocal double[][] arrScales double[][] rotation List<Integer> rperm double[] arrCondition double[] peaks", 0, 0, 4, 2, 2, 0, 2, 1
11201, 11716, 0, "Ambiguous return value: Selected block modifies more than one local variable used in subsequent code. Affected variables are:  double[][] xLocal double[][] arrScales double[][] rotation List<Integer> rperm", 0, 0, 2, 1, 1, 0, 1, 1
9621, 10523, 0, "Ambiguous return value: Selected block modifies more than one local variable used in subsequent code. Affected variables are:  double[] xopt double[] tmp2 double[] b double[][] M BBOBFunction problem", 0, 0, 16, 10, 6, 4, 6, 1
12205, 12338, 1, "OK", 4, 5, 3, 1, 1, 0, 1, 2
11749, 12135, 0, "Ambiguous return value: Selected block modifies more than one local variable used in subsequent code. Affected variables are:  double[] arrCondition double[] peaks", 0, 0, 2, 1, 1, 0, 1, 1
11141, 12561, 0, "Ambiguous return value: Selected block modifies more than one local variable used in subsequent code. Affected variables are:  double fopt double[][] xLocal double[][] arrScales double[][] rotation double[] peaks", 0, 0, 12, 7, 5, 2, 5, 1
11262, 11883, 0, "Ambiguous return value: Selected block modifies more than one local variable used in subsequent code. Affected variables are:  double[][] arrScales double[][] rotation List<Integer> rperm double[] arrCondition double[] peaks", 0, 0, 2, 1, 1, 0, 1, 1
11749, 13164, 1, "OK", 14, 47, 23, 15, 8, 7, 8, 1
5845, 6756, 1, "OK", 4, 26, 9, 6, 3, 3, 3, 1
8871, 9206, 1, "OK", 5, 11, 5, 3, 2, 1, 2, 1
12779, 12988, 1, "OK", 8, 9, 8, 2, 2, 0, 2, 3
11042, 12561, 0, "Ambiguous return value: Selected block modifies more than one local variable used in subsequent code. Affected variables are:  double c double[] xopt double fopt double[][] xLocal double[][] arrScales double[][] rotation double[] peaks", 0, 0, 12, 7, 5, 2, 5, 1
8636, 9325, 0, "Ambiguous return value: Selected block modifies more than one local variable used in subsequent code. Affected variables are:  double[][] rot1 BBOBFunction problem", 0, 0, 5, 3, 2, 1, 2, 1
11061, 12999, 0, "Ambiguous return value: Selected block modifies more than one local variable used in subsequent code. Affected variables are:  double fopt double[][] xLocal double[][] arrScales double[][] rotation double[] peaks", 0, 0, 25, 16, 9, 7, 9, 1
8533, 9447, 1, "OK", 5, 23, 5, 3, 2, 1, 2, 1
9804, 9991, 1, "OK", 3, 9, 5, 3, 2, 1, 2, 1
5381, 5791, 1, "OK", 4, 10, 2, 1, 1, 0, 1, 1
4146, 5161, 1, "OK", 4, 27, 9, 6, 3, 3, 3, 1
9561, 10358, 0, "Ambiguous return value: Selected block modifies more than one local variable used in subsequent code. Affected variables are:  double[] tmp1 double fopt double[] xopt double[] tmp2 double[] b double[][] M", 0, 0, 16, 10, 6, 4, 6, 1
8473, 9264, 0, "Ambiguous return value: Selected block modifies more than one local variable used in subsequent code. Affected variables are:  double[] xopt double[] zeros double[][] rot1 BBOBFunction problem", 0, 0, 5, 3, 2, 1, 2, 1
11887, 12999, 1, "OK", 14, 39, 23, 15, 8, 7, 8, 1
8675, 9149, 0, "Ambiguous return value: Selected block modifies more than one local variable used in subsequent code. Affected variables are:  double[][] M double[][] rot1 BBOBFunction problem", 0, 0, 5, 3, 2, 1, 2, 1
11524, 12999, 1, "OK", 13, 52, 25, 16, 9, 7, 9, 1
11099, 11835, 0, "Ambiguous return value: Selected block modifies more than one local variable used in subsequent code. Affected variables are:  double[] xopt double fopt double[][] xLocal double[][] arrScales double[][] rotation List<Integer> rperm double[] arrCondition", 0, 0, 2, 1, 1, 0, 1, 1
11262, 11901, 0, "Ambiguous return value: Selected block modifies more than one local variable used in subsequent code. Affected variables are:  double[][] arrScales double[][] rotation List<Integer> rperm double[] arrCondition double[] peaks", 0, 0, 2, 1, 1, 0, 1, 1
4146, 5180, 1, "OK", 4, 28, 9, 6, 3, 3, 3, 1
8804, 9264, 1, "OK", 5, 14, 5, 3, 2, 1, 2, 1
9681, 10751, 1, "OK", 3, 36, 16, 10, 6, 4, 6, 1
5381, 5810, 1, "OK", 4, 11, 2, 1, 1, 0, 1, 1
7424, 8013, 0, "Ambiguous return value: Selected block modifies more than one local variable used in subsequent code. Affected variables are:  double[] zeros double[] b double[][] M double[][] rot1", 0, 0, 9, 6, 3, 3, 3, 1
9723, 10467, 0, "Ambiguous return value: Selected block modifies more than one local variable used in subsequent code. Affected variables are:  double[] tmp2 double[] b double[][] M BBOBFunction problem", 0, 0, 16, 10, 6, 4, 6, 1
9857, 10410, 1, "OK", 6, 25, 16, 10, 6, 4, 6, 1
11326, 12999, 0, "Ambiguous return value: Selected block modifies more than one local variable used in subsequent code. Affected variables are:  double[][] rotation double[] peaks", 0, 0, 25, 16, 9, 7, 9, 1
10241, 10805, 1, "OK", 7, 13, 2, 1, 1, 0, 1, 1
11803, 12561, 1, "OK", 9, 24, 10, 6, 4, 2, 4, 1
10977, 12561, 0, "Ambiguous return value: Selected block modifies more than one local variable used in subsequent code. Affected variables are:  double b double c double[] xopt double fopt double[][] xLocal double[][] arrScales double[][] rotation double[] peaks", 0, 0, 12, 7, 5, 2, 5, 1
10944, 12561, 0, "Ambiguous return value: Selected block modifies more than one local variable used in subsequent code. Affected variables are:  double b double c double[] xopt double fopt double[][] xLocal double[][] arrScales double[][] rotation double[] peaks", 0, 0, 12, 7, 5, 2, 5, 1
12681, 12994, 1, "OK", 9, 13, 11, 5, 3, 2, 3, 2
9621, 10580, 0, "Ambiguous return value: Selected block modifies more than one local variable used in subsequent code. Affected variables are:  double[] xopt double[] tmp2 double[] b double[][] M BBOBFunction problem", 0, 0, 16, 10, 6, 4, 6, 1
8533, 9507, 1, "OK", 5, 24, 5, 3, 2, 1, 2, 1
8871, 9264, 1, "OK", 5, 12, 5, 3, 2, 1, 2, 1
8675, 9206, 0, "Ambiguous return value: Selected block modifies more than one local variable used in subsequent code. Affected variables are:  double[][] M double[][] rot1 BBOBFunction problem", 0, 0, 5, 3, 2, 1, 2, 1
8473, 9325, 0, "Ambiguous return value: Selected block modifies more than one local variable used in subsequent code. Affected variables are:  double[] xopt double[] zeros double[][] rot1 BBOBFunction problem", 0, 0, 5, 3, 2, 1, 2, 1
11201, 11799, 0, "Ambiguous return value: Selected block modifies more than one local variable used in subsequent code. Affected variables are:  double[][] xLocal double[][] arrScales double[][] rotation List<Integer> rperm double[] arrCondition", 0, 0, 2, 1, 1, 0, 1, 1
11141, 12634, 0, "Ambiguous return value: Selected block modifies more than one local variable used in subsequent code. Affected variables are:  double fopt double[][] xLocal double[][] arrScales double[][] rotation double[] gallagher_peaks double[] peaks", 0, 0, 12, 7, 5, 2, 5, 1
11099, 11883, 0, "Ambiguous return value: Selected block modifies more than one local variable used in subsequent code. Affected variables are:  double[] xopt double fopt double[][] xLocal double[][] arrScales double[][] rotation List<Integer> rperm double[] arrCondition double[] peaks", 0, 0, 2, 1, 1, 0, 1, 1
12205, 12413, 1, "OK", 4, 7, 3, 1, 1, 0, 1, 2
9996, 10236, 1, "OK", 3, 10, 9, 6, 3, 3, 3, 1
9561, 10410, 0, "Ambiguous return value: Selected block modifies more than one local variable used in subsequent code. Affected variables are:  double[] tmp1 double fopt double[] xopt double[] tmp2 double[] b double[][] M BBOBFunction problem", 0, 0, 16, 10, 6, 4, 6, 1
8636, 9390, 1, "OK", 4, 20, 5, 3, 2, 1, 2, 1
9765, 10236, 0, "Ambiguous return value: Selected block modifies more than one local variable used in subsequent code. Affected variables are:  double[] b double[][] M", 0, 0, 14, 9, 5, 4, 5, 1
11042, 12634, 0, "Ambiguous return value: Selected block modifies more than one local variable used in subsequent code. Affected variables are:  double c double[] xopt double fopt double[][] xLocal double[][] arrScales double[][] rotation double[] gallagher_peaks double[] peaks", 0, 0, 12, 7, 5, 2, 5, 1
7424, 8066, 0, "Ambiguous return value: Selected block modifies more than one local variable used in subsequent code. Affected variables are:  double[] zeros double[] b double[][] M double[][] rot1 BBOBFunction problem", 0, 0, 9, 6, 3, 3, 3, 1
9681, 10805, 1, "OK", 3, 37, 16, 10, 6, 4, 6, 1
4358, 4812, 1, "OK", 4, 15, 9, 6, 3, 3, 3, 1
9723, 10523, 0, "Ambiguous return value: Selected block modifies more than one local variable used in subsequent code. Affected variables are:  double[] tmp2 double[] b double[][] M BBOBFunction problem", 0, 0, 16, 10, 6, 4, 6, 1
8533, 9526, 1, "OK", 5, 25, 5, 3, 2, 1, 2, 1
9536, 13249, 1, "OK", 4, 116, 44, 44, 18, 26, 15, 0
11099, 11901, 0, "Ambiguous return value: Selected block modifies more than one local variable used in subsequent code. Affected variables are:  double[] xopt double fopt double[][] xLocal double[][] arrScales double[][] rotation List<Integer> rperm double[] arrCondition double[] peaks", 0, 0, 2, 1, 1, 0, 1, 1
9857, 10467, 1, "OK", 7, 26, 16, 10, 6, 4, 6, 1
11061, 13088, 0, "Ambiguous return value: Selected block modifies more than one local variable used in subsequent code. Affected variables are:  double fopt BBOBFunction problem", 0, 0, 25, 16, 9, 7, 9, 1
10241, 10862, 1, "OK", 8, 14, 2, 1, 1, 0, 1, 1
8804, 9325, 1, "OK", 5, 15, 5, 3, 2, 1, 2, 1
11262, 12999, 0, "Ambiguous return value: Selected block modifies more than one local variable used in subsequent code. Affected variables are:  double[][] arrScales double[][] rotation double[] peaks", 0, 0, 25, 16, 9, 7, 9, 1
10891, 13249, 1, "OK", 4, 74, 27, 27, 11, 16, 9, 0
11141, 11642, 0, "Ambiguous return value: Selected block modifies more than one local variable used in subsequent code. Affected variables are:  double fopt double[][] xLocal double[][] arrScales double[][] rotation double[] gallagher_peaks List<Integer> rperm", 0, 0, 2, 1, 1, 0, 1, 1
11887, 13088, 1, "OK", 14, 41, 23, 15, 8, 7, 8, 1
11524, 13088, 1, "OK", 13, 54, 25, 16, 9, 7, 9, 1
11042, 11642, 0, "Ambiguous return value: Selected block modifies more than one local variable used in subsequent code. Affected variables are:  double c double[] fitvalues double[] xopt double fopt double[][] xLocal double[][] arrScales double[][] rotation double[] gallagher_peaks List<Integer> rperm", 0, 0, 2, 1, 1, 0, 1, 1
9621, 10638, 0, "Ambiguous return value: Selected block modifies more than one local variable used in subsequent code. Affected variables are:  double[] xopt double[] tmp2 BBOBFunction problem", 0, 0, 16, 10, 6, 4, 6, 1
10944, 12634, 0, "Ambiguous return value: Selected block modifies more than one local variable used in subsequent code. Affected variables are:  double b double c double[] xopt double fopt double[][] xLocal double[][] arrScales double[][] rotation double[] gallagher_peaks double[] peaks", 0, 0, 12, 7, 5, 2, 5, 1
11201, 11835, 0, "Ambiguous return value: Selected block modifies more than one local variable used in subsequent code. Affected variables are:  double[][] xLocal double[][] arrScales double[][] rotation List<Integer> rperm double[] arrCondition", 0, 0, 2, 1, 1, 0, 1, 1
10977, 12634, 0, "Ambiguous return value: Selected block modifies more than one local variable used in subsequent code. Affected variables are:  double b double c double[] xopt double fopt double[][] xLocal double[][] arrScales double[][] rotation double[] gallagher_peaks double[] peaks", 0, 0, 12, 7, 5, 2, 5, 1
8871, 9325, 1, "OK", 5, 13, 5, 3, 2, 1, 2, 1
7559, 8013, 1, "OK", 4, 15, 9, 6, 3, 3, 3, 1
10241, 10881, 1, "OK", 8, 15, 2, 1, 1, 0, 1, 1
11803, 12634, 0, "Ambiguous return value: Selected block modifies more than one local variable used in subsequent code. Affected variables are:  double[] gallagher_peaks double[] peaks", 0, 0, 10, 6, 4, 2, 4, 1
11326, 13088, 1, "OK", 11, 58, 25, 16, 9, 7, 9, 1
8636, 9447, 1, "OK", 5, 21, 5, 3, 2, 1, 2, 1
8675, 9264, 0, "Ambiguous return value: Selected block modifies more than one local variable used in subsequent code. Affected variables are:  double[][] rot1 BBOBFunction problem", 0, 0, 5, 3, 2, 1, 2, 1
9561, 10467, 0, "Ambiguous return value: Selected block modifies more than one local variable used in subsequent code. Affected variables are:  double[] tmp1 double[] xopt double[] tmp2 double[] b double[][] M BBOBFunction problem", 0, 0, 16, 10, 6, 4, 6, 1
4624, 4801, 1, "OK", 6, 4, 4, 1, 1, 0, 1, 3
8473, 9390, 0, "Ambiguous return value: Selected block modifies more than one local variable used in subsequent code. Affected variables are:  double[] xopt BBOBFunction problem", 0, 0, 5, 3, 2, 1, 2, 1
12276, 12338, 1, "OK", 2, 3, 3, 1, 1, 0, 1, 2
9681, 10862, 1, "OK", 4, 38, 16, 10, 6, 4, 6, 1
9723, 10580, 0, "Ambiguous return value: Selected block modifies more than one local variable used in subsequent code. Affected variables are:  double[] tmp2 double[] b double[][] M BBOBFunction problem", 0, 0, 16, 10, 6, 4, 6, 1
10944, 11642, 0, "Ambiguous return value: Selected block modifies more than one local variable used in subsequent code. Affected variables are:  double maxcondition double maxcondition1 double b double c double[] fitvalues double[] xopt double fopt double[][] xLocal double[][] arrScales double[][] rotation double[] gallagher_peaks List<Integer> rperm", 0, 0, 2, 1, 1, 0, 1, 1
7424, 8123, 0, "Ambiguous return value: Selected block modifies more than one local variable used in subsequent code. Affected variables are:  double[] zeros double[] b double[][] M double[][] rot1 BBOBFunction problem", 0, 0, 9, 6, 3, 3, 3, 1
9857, 10523, 1, "OK", 7, 27, 16, 10, 6, 4, 6, 1
10977, 11642, 0, "Ambiguous return value: Selected block modifies more than one local variable used in subsequent code. Affected variables are:  double maxcondition1 double b double c double[] fitvalues double[] xopt double fopt double[][] xLocal double[][] arrScales double[][] rotation double[] gallagher_peaks List<Integer> rperm", 0, 0, 2, 1, 1, 0, 1, 1
11061, 13145, 1, "OK", 9, 64, 25, 16, 9, 7, 9, 1
10098, 10225, 1, "OK", 4, 4, 4, 1, 1, 0, 1, 3
8448, 13249, 1, "OK", 4, 143, 50, 50, 21, 29, 17, 0
11099, 12999, 0, "Ambiguous return value: Selected block modifies more than one local variable used in subsequent code. Affected variables are:  double fopt double[][] xLocal double[][] arrScales double[][] rotation double[] peaks", 0, 0, 25, 16, 9, 7, 9, 1
4358, 4878, 1, "OK", 5, 17, 9, 6, 3, 3, 3, 1
11201, 11883, 0, "Ambiguous return value: Selected block modifies more than one local variable used in subsequent code. Affected variables are:  double[][] xLocal double[][] arrScales double[][] rotation List<Integer> rperm double[] arrCondition double[] peaks", 0, 0, 2, 1, 1, 0, 1, 1
11887, 13145, 1, "OK", 15, 42, 23, 15, 8, 7, 8, 1
8804, 9390, 1, "OK", 7, 16, 5, 3, 2, 1, 2, 1
7825, 8002, 1, "OK", 6, 4, 4, 1, 1, 0, 1, 3
11524, 13145, 1, "OK", 14, 55, 25, 16, 9, 7, 9, 1
9681, 10881, 1, "OK", 4, 39, 16, 10, 6, 4, 6, 1
11906, 12561, 1, "OK", 9, 19, 10, 6, 4, 2, 4, 1
11061, 12135, 0, "Ambiguous return value: Selected block modifies more than one local variable used in subsequent code. Affected variables are:  double[] xopt double fopt double[][] xLocal double[][] arrScales double[][] rotation List<Integer> rperm double[] arrCondition double[] peaks", 0, 0, 4, 2, 2, 0, 2, 1
8913, 9091, 1, "OK", 5, 6, 3, 1, 1, 0, 1, 2
9621, 10695, 0, "Ambiguous return value: Selected block modifies more than one local variable used in subsequent code. Affected variables are:  double[] xopt BBOBFunction problem", 0, 0, 16, 10, 6, 4, 6, 1
11840, 12561, 1, "OK", 8, 22, 10, 6, 4, 2, 4, 1
11201, 11901, 0, "Ambiguous return value: Selected block modifies more than one local variable used in subsequent code. Affected variables are:  double[][] xLocal double[][] arrScales double[][] rotation List<Integer> rperm double[] arrCondition double[] peaks", 0, 0, 2, 1, 1, 0, 1, 1
11326, 13145, 1, "OK", 12, 59, 25, 16, 9, 7, 9, 1
11887, 13164, 1, "OK", 15, 43, 23, 15, 8, 7, 8, 1
11887, 12135, 1, "OK", 6, 6, 2, 1, 1, 0, 1, 1
11061, 13164, 1, "OK", 9, 65, 25, 16, 9, 7, 9, 1
7559, 8066, 0, "Ambiguous return value: Selected block modifies more than one local variable used in subsequent code. Affected variables are:  double[][] rot1 BBOBFunction problem", 0, 0, 9, 6, 3, 3, 3, 1
11576, 12561, 1, "OK", 9, 32, 12, 7, 5, 2, 5, 1
11524, 12135, 0, "Ambiguous return value: Selected block modifies more than one local variable used in subsequent code. Affected variables are:  List<Integer> rperm double[] arrCondition double[] peaks", 0, 0, 4, 2, 2, 0, 2, 1
6057, 6511, 1, "OK", 4, 15, 9, 6, 3, 3, 3, 1
11141, 11716, 0, "Ambiguous return value: Selected block modifies more than one local variable used in subsequent code. Affected variables are:  double fopt double[][] xLocal double[][] arrScales double[][] rotation List<Integer> rperm", 0, 0, 2, 1, 1, 0, 1, 1
11042, 11716, 0, "Ambiguous return value: Selected block modifies more than one local variable used in subsequent code. Affected variables are:  double c double[] fitvalues double[] xopt double fopt double[][] xLocal double[][] arrScales double[][] rotation List<Integer> rperm", 0, 0, 2, 1, 1, 0, 1, 1
11262, 13088, 1, "OK", 10, 59, 25, 16, 9, 7, 9, 1
9561, 10523, 0, "Ambiguous return value: Selected block modifies more than one local variable used in subsequent code. Affected variables are:  double[] tmp1 double[] xopt double[] tmp2 double[] b double[][] M BBOBFunction problem", 0, 0, 16, 10, 6, 4, 6, 1
4122, 13249, 1, "OK", 4, 257, 84, 84, 36, 48, 27, 0
11326, 13164, 1, "OK", 12, 60, 25, 16, 9, 7, 9, 1
8473, 9447, 1, "OK", 4, 24, 5, 3, 2, 1, 2, 1
10916, 12561, 0, "Ambiguous return value: Selected block modifies more than one local variable used in subsequent code. Affected variables are:  int numberOfPeaks double b double c double[] xopt double fopt double[][] xLocal double[][] arrScales double[][] rotation double[] peaks", 0, 0, 12, 7, 5, 2, 5, 1
8636, 9507, 1, "OK", 5, 22, 5, 3, 2, 1, 2, 1
8871, 9390, 1, "OK", 7, 14, 5, 3, 2, 1, 2, 1
11524, 13164, 1, "OK", 14, 56, 25, 16, 9, 7, 9, 1
8675, 9325, 0, "Ambiguous return value: Selected block modifies more than one local variable used in subsequent code. Affected variables are:  double[][] rot1 BBOBFunction problem", 0, 0, 5, 3, 2, 1, 2, 1
9996, 10358, 1, "OK", 6, 15, 11, 7, 4, 3, 4, 1
11326, 12135, 0, "Ambiguous return value: Selected block modifies more than one local variable used in subsequent code. Affected variables are:  double[][] rotation List<Integer> rperm double[] arrCondition double[] peaks", 0, 0, 4, 2, 2, 0, 2, 1
9723, 10638, 0, "Ambiguous return value: Selected block modifies more than one local variable used in subsequent code. Affected variables are:  double[] tmp2 BBOBFunction problem", 0, 0, 16, 10, 6, 4, 6, 1
9857, 10580, 1, "OK", 7, 28, 16, 10, 6, 4, 6, 1
7424, 8181, 0, "Ambiguous return value: Selected block modifies more than one local variable used in subsequent code. Affected variables are:  double[] zeros double[][] rot1 BBOBFunction problem", 0, 0, 9, 6, 3, 3, 3, 1
9765, 10358, 0, "Ambiguous return value: Selected block modifies more than one local variable used in subsequent code. Affected variables are:  double[] b double[][] M", 0, 0, 16, 10, 6, 4, 6, 1
4560, 4807, 1, "OK", 5, 8, 7, 3, 2, 1, 2, 2
8636, 9526, 1, "OK", 5, 23, 5, 3, 2, 1, 2, 1
8804, 9447, 1, "OK", 8, 17, 5, 3, 2, 1, 2, 1
10944, 11716, 0, "Ambiguous return value: Selected block modifies more than one local variable used in subsequent code. Affected variables are:  double maxcondition double maxcondition1 double b double c double[] fitvalues double[] xopt double fopt double[][] xLocal double[][] arrScales double[][] rotation List<Integer> rperm", 0, 0, 2, 1, 1, 0, 1, 1
10977, 11716, 0, "Ambiguous return value: Selected block modifies more than one local variable used in subsequent code. Affected variables are:  double maxcondition1 double b double c double[] fitvalues double[] xopt double fopt double[][] xLocal double[][] arrScales double[][] rotation List<Integer> rperm", 0, 0, 2, 1, 1, 0, 1, 1
4358, 4933, 1, "OK", 5, 18, 9, 6, 3, 3, 3, 1
12205, 12556, 1, "OK", 6, 11, 6, 2, 2, 0, 2, 2
7364, 8013, 0, "Ambiguous return value: Selected block modifies more than one local variable used in subsequent code. Affected variables are:  double fopt double[] zeros double[] b double[][] M double[][] rot1", 0, 0, 9, 6, 3, 3, 3, 1
12276, 12413, 1, "OK", 3, 5, 3, 1, 1, 0, 1, 2
9621, 10751, 1, "OK", 4, 37, 16, 10, 6, 4, 6, 1
6323, 6500, 1, "OK", 6, 4, 4, 1, 1, 0, 1, 3
7559, 8123, 0, "Ambiguous return value: Selected block modifies more than one local variable used in subsequent code. Affected variables are:  double[][] rot1 BBOBFunction problem", 0, 0, 9, 6, 3, 3, 3, 1
6766, 13249, 1, "OK", 4, 185, 61, 61, 26, 35, 20, 0
9561, 10580, 0, "Ambiguous return value: Selected block modifies more than one local variable used in subsequent code. Affected variables are:  double[] xopt double[] tmp2 double[] b double[][] M BBOBFunction problem", 0, 0, 16, 10, 6, 4, 6, 1
11262, 13145, 1, "OK", 11, 60, 25, 16, 9, 7, 9, 1
7761, 8008, 1, "OK", 5, 8, 7, 3, 2, 1, 2, 2
9996, 10410, 1, "OK", 6, 17, 11, 7, 4, 3, 4, 1
11906, 12634, 1, "OK", 9, 21, 10, 6, 4, 2, 4, 1
11840, 12634, 0, "Ambiguous return value: Selected block modifies more than one local variable used in subsequent code. Affected variables are:  double[] gallagher_peaks double[] peaks", 0, 0, 10, 6, 4, 2, 4, 1
6057, 6565, 1, "OK", 4, 17, 9, 6, 3, 3, 3, 1
9765, 10410, 0, "Ambiguous return value: Selected block modifies more than one local variable used in subsequent code. Affected variables are:  double[] b double[][] M BBOBFunction problem", 0, 0, 16, 10, 6, 4, 6, 1
11201, 12999, 0, "Ambiguous return value: Selected block modifies more than one local variable used in subsequent code. Affected variables are:  double[][] xLocal double[][] arrScales double[][] rotation double[] peaks", 0, 0, 25, 16, 9, 7, 9, 1
11099, 13088, 0, "Ambiguous return value: Selected block modifies more than one local variable used in subsequent code. Affected variables are:  double fopt BBOBFunction problem", 0, 0, 25, 16, 9, 7, 9, 1
12140, 12561, 1, "OK", 6, 14, 8, 5, 3, 2, 3, 1
8871, 9447, 1, "OK", 8, 15, 5, 3, 2, 1, 2, 1
11576, 12634, 0, "Ambiguous return value: Selected block modifies more than one local variable used in subsequent code. Affected variables are:  double[] gallagher_peaks double[] peaks", 0, 0, 12, 7, 5, 2, 5, 1
8675, 9390, 1, "OK", 5, 19, 5, 3, 2, 1, 2, 1
9723, 10695, 1, "OK", 4, 34, 16, 10, 6, 4, 6, 1
9857, 10638, 1, "OK", 7, 29, 16, 10, 6, 4, 6, 1
11262, 13164, 1, "OK", 11, 61, 25, 16, 9, 7, 9, 1
8473, 9507, 1, "OK", 4, 25, 5, 3, 2, 1, 2, 1
11262, 12135, 0, "Ambiguous return value: Selected block modifies more than one local variable used in subsequent code. Affected variables are:  double[][] arrScales double[][] rotation List<Integer> rperm double[] arrCondition double[] peaks", 0, 0, 4, 2, 2, 0, 2, 1
7424, 8242, 0, "Ambiguous return value: Selected block modifies more than one local variable used in subsequent code. Affected variables are:  double[] zeros double[][] rot1 BBOBFunction problem", 0, 0, 9, 6, 3, 3, 3, 1
10916, 12634, 0, "Ambiguous return value: Selected block modifies more than one local variable used in subsequent code. Affected variables are:  int numberOfPeaks double b double c double[] xopt double fopt double[][] xLocal double[][] arrScales double[][] rotation double[] gallagher_peaks double[] peaks", 0, 0, 12, 7, 5, 2, 5, 1
11042, 11799, 0, "Ambiguous return value: Selected block modifies more than one local variable used in subsequent code. Affected variables are:  double c double[] fitvalues double[] xopt double fopt double[][] xLocal double[][] arrScales double[][] rotation List<Integer> rperm double[] arrCondition", 0, 0, 2, 1, 1, 0, 1, 1
9804, 10236, 1, "OK", 4, 20, 14, 9, 5, 4, 5, 1
11141, 11799, 0, "Ambiguous return value: Selected block modifies more than one local variable used in subsequent code. Affected variables are:  double fopt double[][] xLocal double[][] arrScales double[][] rotation List<Integer> rperm double[] arrCondition", 0, 0, 2, 1, 1, 0, 1, 1
4358, 4989, 1, "OK", 5, 19, 9, 6, 3, 3, 3, 1
8473, 9526, 1, "OK", 4, 26, 5, 3, 2, 1, 2, 1
7364, 8066, 0, "Ambiguous return value: Selected block modifies more than one local variable used in subsequent code. Affected variables are:  double fopt double[] zeros double[] b double[][] M double[][] rot1 BBOBFunction problem", 0, 0, 9, 6, 3, 3, 3, 1
3398, 13249, 1, "OK", 4, 274, 86, 86, 38, 48, 27, 0
8804, 9507, 1, "OK", 8, 18, 5, 3, 2, 1, 2, 1
5334, 5468, 1, "OK", 2, 6, 2, 1, 1, 0, 1, 1
9621, 10805, 1, "OK", 4, 38, 16, 10, 6, 4, 6, 1
11576, 11642, 1, "OK", 2, 3, 2, 1, 1, 0, 1, 1
7559, 8181, 0, "Ambiguous return value: Selected block modifies more than one local variable used in subsequent code. Affected variables are:  double[][] rot1 BBOBFunction problem", 0, 0, 9, 6, 3, 3, 3, 1
9561, 10638, 0, "Ambiguous return value: Selected block modifies more than one local variable used in subsequent code. Affected variables are:  double[] xopt double[] tmp2 BBOBFunction problem", 0, 0, 16, 10, 6, 4, 6, 1
10916, 11642, 0, "Ambiguous return value: Selected block modifies more than one local variable used in subsequent code. Affected variables are:  int numberOfPeaks double maxcondition double maxcondition1 double b double c double[] fitvalues double[] xopt double fopt double[][] xLocal double[][] arrScales double[][] rotation double[] gallagher_peaks List<Integer> rperm", 0, 0, 2, 1, 1, 0, 1, 1
10977, 11799, 0, "Ambiguous return value: Selected block modifies more than one local variable used in subsequent code. Affected variables are:  double maxcondition1 double b double c double[] fitvalues double[] xopt double fopt double[][] xLocal double[][] arrScales double[][] rotation List<Integer> rperm double[] arrCondition", 0, 0, 2, 1, 1, 0, 1, 1
11141, 11835, 0, "Ambiguous return value: Selected block modifies more than one local variable used in subsequent code. Affected variables are:  double fopt double[][] xLocal double[][] arrScales double[][] rotation List<Integer> rperm double[] arrCondition", 0, 0, 2, 1, 1, 0, 1, 1
9681, 9991, 0, "Ambiguous return value: Selected block modifies more than one local variable used in subsequent code. Affected variables are:  double[] xopt double[] tmp2 double[] b double[][] M", 0, 0, 5, 3, 2, 1, 2, 1
6057, 6622, 1, "OK", 5, 18, 9, 6, 3, 3, 3, 1
8804, 9526, 1, "OK", 8, 19, 5, 3, 2, 1, 2, 1
8871, 9507, 1, "OK", 8, 16, 5, 3, 2, 1, 2, 1
11099, 13145, 1, "OK", 10, 63, 25, 16, 9, 7, 9, 1
6259, 6506, 1, "OK", 5, 8, 7, 3, 2, 1, 2, 2
9765, 10467, 0, "Ambiguous return value: Selected block modifies more than one local variable used in subsequent code. Affected variables are:  double[] b double[][] M BBOBFunction problem", 0, 0, 16, 10, 6, 4, 6, 1
9996, 10467, 1, "OK", 7, 18, 11, 7, 4, 3, 4, 1
10944, 11799, 0, "Ambiguous return value: Selected block modifies more than one local variable used in subsequent code. Affected variables are:  double maxcondition double maxcondition1 double b double c double[] fitvalues double[] xopt double fopt double[][] xLocal double[][] arrScales double[][] rotation List<Integer> rperm double[] arrCondition", 0, 0, 2, 1, 1, 0, 1, 1
11042, 11835, 0, "Ambiguous return value: Selected block modifies more than one local variable used in subsequent code. Affected variables are:  double c double[] fitvalues double[] xopt double fopt double[][] xLocal double[][] arrScales double[][] rotation List<Integer> rperm double[] arrCondition", 0, 0, 2, 1, 1, 0, 1, 1
4266, 4812, 0, "Ambiguous return value: Selected block modifies more than one local variable used in subsequent code. Affected variables are:  double[] b double[][] M", 0, 0, 9, 6, 3, 3, 3, 1
8675, 9447, 1, "OK", 6, 20, 5, 3, 2, 1, 2, 1
9723, 10751, 1, "OK", 4, 35, 16, 10, 6, 4, 6, 1
9857, 10695, 1, "OK", 7, 30, 16, 10, 6, 4, 6, 1
11099, 12135, 0, "Ambiguous return value: Selected block modifies more than one local variable used in subsequent code. Affected variables are:  double[] xopt double fopt double[][] xLocal double[][] arrScales double[][] rotation List<Integer> rperm double[] arrCondition double[] peaks", 0, 0, 4, 2, 2, 0, 2, 1
7424, 8297, 0, "Ambiguous return value: Selected block modifies more than one local variable used in subsequent code. Affected variables are:  double[] zeros double[][] rot1 BBOBFunction problem", 0, 0, 9, 6, 3, 3, 3, 1
12140, 12634, 1, "OK", 6, 16, 8, 5, 3, 2, 3, 1
4358, 5046, 1, "OK", 6, 20, 9, 6, 3, 3, 3, 1
8871, 9526, 1, "OK", 8, 17, 5, 3, 2, 1, 2, 1
11647, 12561, 1, "OK", 9, 28, 10, 6, 4, 2, 4, 1
11099, 13164, 1, "OK", 10, 64, 25, 16, 9, 7, 9, 1
10944, 11835, 0, "Ambiguous return value: Selected block modifies more than one local variable used in subsequent code. Affected variables are:  double maxcondition double b double c double[] fitvalues double[] xopt double fopt double[][] xLocal double[][] arrScales double[][] rotation List<Integer> rperm double[] arrCondition", 0, 0, 2, 1, 1, 0, 1, 1
7364, 8123, 0, "Ambiguous return value: Selected block modifies more than one local variable used in subsequent code. Affected variables are:  double[] zeros double[] b double[][] M double[][] rot1 BBOBFunction problem", 0, 0, 9, 6, 3, 3, 3, 1
9621, 10862, 1, "OK", 5, 39, 16, 10, 6, 4, 6, 1
10977, 11835, 0, "Ambiguous return value: Selected block modifies more than one local variable used in subsequent code. Affected variables are:  double b double c double[] fitvalues double[] xopt double fopt double[][] xLocal double[][] arrScales double[][] rotation List<Integer> rperm double[] arrCondition", 0, 0, 2, 1, 1, 0, 1, 1
5334, 5522, 0, "Ambiguous return value: Selected block modifies more than one local variable used in subsequent code. Affected variables are:  double[] minusOne BBOBFunction problem", 0, 0, 2, 1, 1, 0, 1, 1
7467, 8013, 0, "Ambiguous return value: Selected block modifies more than one local variable used in subsequent code. Affected variables are:  double[] b double[][] M double[][] rot1", 0, 0, 9, 6, 3, 3, 3, 1
11141, 11883, 0, "Ambiguous return value: Selected block modifies more than one local variable used in subsequent code. Affected variables are:  double fopt double[][] xLocal double[][] arrScales double[][] rotation List<Integer> rperm double[] arrCondition double[] peaks", 0, 0, 2, 1, 1, 0, 1, 1
11201, 13088, 1, "OK", 9, 60, 25, 16, 9, 7, 9, 1
10038, 10231, 1, "OK", 4, 8, 7, 3, 2, 1, 2, 2
11576, 11716, 1, "OK", 3, 5, 2, 1, 1, 0, 1, 1
9621, 10881, 1, "OK", 5, 40, 16, 10, 6, 4, 6, 1
9561, 10695, 0, "Ambiguous return value: Selected block modifies more than one local variable used in subsequent code. Affected variables are:  double[] xopt BBOBFunction problem", 0, 0, 16, 10, 6, 4, 6, 1
3731, 13249, 1, "OK", 4, 266, 85, 85, 37, 48, 27, 0
7559, 8242, 0, "Ambiguous return value: Selected block modifies more than one local variable used in subsequent code. Affected variables are:  double[][] rot1 BBOBFunction problem", 0, 0, 9, 6, 3, 3, 3, 1
11042, 11883, 0, "Ambiguous return value: Selected block modifies more than one local variable used in subsequent code. Affected variables are:  double c double[] fitvalues double[] xopt double fopt double[][] xLocal double[][] arrScales double[][] rotation List<Integer> rperm double[] arrCondition double[] peaks", 0, 0, 2, 1, 1, 0, 1, 1
6057, 6680, 1, "OK", 5, 19, 9, 6, 3, 3, 3, 1
9765, 10523, 0, "Ambiguous return value: Selected block modifies more than one local variable used in subsequent code. Affected variables are:  double[] b double[][] M BBOBFunction problem", 0, 0, 16, 10, 6, 4, 6, 1
9996, 10523, 1, "OK", 7, 19, 11, 7, 4, 3, 4, 1
11042, 11901, 0, "Ambiguous return value: Selected block modifies more than one local variable used in subsequent code. Affected variables are:  double c double[] fitvalues double[] xopt double fopt double[][] xLocal double[][] arrScales double[][] rotation List<Integer> rperm double[] arrCondition double[] peaks", 0, 0, 2, 1, 1, 0, 1, 1
9857, 10751, 1, "OK", 7, 31, 16, 10, 6, 4, 6, 1
11141, 11901, 0, "Ambiguous return value: Selected block modifies more than one local variable used in subsequent code. Affected variables are:  double fopt double[][] xLocal double[][] arrScales double[][] rotation List<Integer> rperm double[] arrCondition double[] peaks", 0, 0, 2, 1, 1, 0, 1, 1
9723, 10805, 1, "OK", 4, 36, 16, 10, 6, 4, 6, 1
12276, 12556, 1, "OK", 6, 9, 6, 2, 2, 0, 2, 2
10916, 11716, 0, "Ambiguous return value: Selected block modifies more than one local variable used in subsequent code. Affected variables are:  int numberOfPeaks double maxcondition double maxcondition1 double b double c double[] fitvalues double[] xopt double fopt double[][] xLocal double[][] arrScales double[][] rotation List<Integer> rperm", 0, 0, 2, 1, 1, 0, 1, 1
8675, 9507, 1, "OK", 6, 21, 5, 3, 2, 1, 2, 1
4266, 4878, 0, "Ambiguous return value: Selected block modifies more than one local variable used in subsequent code. Affected variables are:  double[] b double[][] M BBOBFunction problem", 0, 0, 9, 6, 3, 3, 3, 1
7424, 8362, 1, "OK", 3, 26, 9, 6, 3, 3, 3, 1
4358, 5104, 1, "OK", 6, 21, 9, 6, 3, 3, 3, 1
10944, 11883, 0, "Ambiguous return value: Selected block modifies more than one local variable used in subsequent code. Affected variables are:  double maxcondition double b double c double[] fitvalues double[] xopt double fopt double[][] xLocal double[][] arrScales double[][] rotation List<Integer> rperm double[] arrCondition double[] peaks", 0, 0, 2, 1, 1, 0, 1, 1
10977, 11883, 0, "Ambiguous return value: Selected block modifies more than one local variable used in subsequent code. Affected variables are:  double b double c double[] fitvalues double[] xopt double fopt double[][] xLocal double[][] arrScales double[][] rotation List<Integer> rperm double[] arrCondition double[] peaks", 0, 0, 2, 1, 1, 0, 1, 1
9804, 10358, 1, "OK", 5, 25, 16, 10, 6, 4, 6, 1
8675, 9526, 1, "OK", 6, 22, 5, 3, 2, 1, 2, 1
7364, 8181, 0, "Ambiguous return value: Selected block modifies more than one local variable used in subsequent code. Affected variables are:  double[] zeros double[][] rot1 BBOBFunction problem", 0, 0, 9, 6, 3, 3, 3, 1
11451, 12561, 1, "OK", 7, 35, 12, 7, 5, 2, 5, 1
5334, 5583, 1, "OK", 2, 9, 2, 1, 1, 0, 1, 1
10977, 11901, 0, "Ambiguous return value: Selected block modifies more than one local variable used in subsequent code. Affected variables are:  double b double c double[] fitvalues double[] xopt double fopt double[][] xLocal double[][] arrScales double[][] rotation List<Integer> rperm double[] arrCondition double[] peaks", 0, 0, 2, 1, 1, 0, 1, 1
4434, 4812, 1, "OK", 5, 14, 9, 6, 3, 3, 3, 1
11647, 12634, 0, "Ambiguous return value: Selected block modifies more than one local variable used in subsequent code. Affected variables are:  double[] gallagher_peaks double[] peaks", 0, 0, 10, 6, 4, 2, 4, 1
7467, 8066, 0, "Ambiguous return value: Selected block modifies more than one local variable used in subsequent code. Affected variables are:  double[] b double[][] M double[][] rot1 BBOBFunction problem", 0, 0, 9, 6, 3, 3, 3, 1
10944, 11901, 0, "Ambiguous return value: Selected block modifies more than one local variable used in subsequent code. Affected variables are:  double maxcondition double b double c double[] fitvalues double[] xopt double fopt double[][] xLocal double[][] arrScales double[][] rotation List<Integer> rperm double[] arrCondition double[] peaks", 0, 0, 2, 1, 1, 0, 1, 1
11201, 13145, 1, "OK", 10, 61, 25, 16, 9, 7, 9, 1
7559, 8297, 0, "Ambiguous return value: Selected block modifies more than one local variable used in subsequent code. Affected variables are:  double[][] rot1 BBOBFunction problem", 0, 0, 9, 6, 3, 3, 3, 1
5965, 6511, 0, "Ambiguous return value: Selected block modifies more than one local variable used in subsequent code. Affected variables are:  double[] b double[][] M", 0, 0, 9, 6, 3, 3, 3, 1
11022, 12561, 0, "Ambiguous return value: Selected block modifies more than one local variable used in subsequent code. Affected variables are:  double b double c double[] xopt double fopt double[][] xLocal double[][] arrScales double[][] rotation double[] peaks", 0, 0, 12, 7, 5, 2, 5, 1
11201, 12135, 0, "Ambiguous return value: Selected block modifies more than one local variable used in subsequent code. Affected variables are:  double[][] xLocal double[][] arrScales double[][] rotation List<Integer> rperm double[] arrCondition double[] peaks", 0, 0, 4, 2, 2, 0, 2, 1
9561, 10751, 1, "OK", 4, 38, 16, 10, 6, 4, 6, 1
7304, 8013, 0, "Ambiguous return value: Selected block modifies more than one local variable used in subsequent code. Affected variables are:  double[] xopt double fopt double[] zeros double[] b double[][] M double[][] rot1", 0, 0, 9, 6, 3, 3, 3, 1
11749, 12561, 1, "OK", 8, 25, 10, 6, 4, 2, 4, 1
11201, 13164, 1, "OK", 10, 62, 25, 16, 9, 7, 9, 1
6057, 6737, 1, "OK", 6, 20, 9, 6, 3, 3, 3, 1
9996, 10580, 1, "OK", 7, 20, 11, 7, 4, 3, 4, 1
9723, 10862, 1, "OK", 5, 37, 16, 10, 6, 4, 6, 1
9857, 10805, 1, "OK", 7, 32, 16, 10, 6, 4, 6, 1
12344, 12556, 1, "OK", 6, 5, 3, 1, 1, 0, 1, 2
9765, 10580, 0, "Ambiguous return value: Selected block modifies more than one local variable used in subsequent code. Affected variables are:  double[] b double[][] M BBOBFunction problem", 0, 0, 16, 10, 6, 4, 6, 1
7635, 8013, 1, "OK", 5, 14, 9, 6, 3, 3, 3, 1
4501, 4812, 1, "OK", 5, 12, 9, 6, 3, 3, 3, 1
9804, 10410, 0, "Ambiguous return value: Selected block modifies more than one local variable used in subsequent code. Affected variables are:  double[][] M BBOBFunction problem", 0, 0, 16, 10, 6, 4, 6, 1
12186, 12338, 1, "OK", 4, 6, 3, 1, 1, 0, 1, 2
4266, 4933, 0, "Ambiguous return value: Selected block modifies more than one local variable used in subsequent code. Affected variables are:  double[] b double[][] M BBOBFunction problem", 0, 0, 9, 6, 3, 3, 3, 1
6057, 6756, 1, "OK", 6, 21, 9, 6, 3, 3, 3, 1
9723, 10881, 1, "OK", 5, 38, 16, 10, 6, 4, 6, 1
11042, 12999, 0, "Ambiguous return value: Selected block modifies more than one local variable used in subsequent code. Affected variables are:  double fopt double[][] xLocal double[][] arrScales double[][] rotation double[] peaks", 0, 0, 25, 16, 9, 7, 9, 1
11576, 11799, 1, "OK", 3, 8, 2, 1, 1, 0, 1, 1
4358, 5161, 1, "OK", 6, 22, 9, 6, 3, 3, 3, 1
11141, 12999, 0, "Ambiguous return value: Selected block modifies more than one local variable used in subsequent code. Affected variables are:  double fopt double[][] xLocal double[][] arrScales double[][] rotation double[] peaks", 0, 0, 25, 16, 9, 7, 9, 1
7424, 8419, 1, "OK", 4, 27, 9, 6, 3, 3, 3, 1
7364, 8242, 0, "Ambiguous return value: Selected block modifies more than one local variable used in subsequent code. Affected variables are:  double[] zeros double[][] rot1 BBOBFunction problem", 0, 0, 9, 6, 3, 3, 3, 1
10916, 11799, 0, "Ambiguous return value: Selected block modifies more than one local variable used in subsequent code. Affected variables are:  int numberOfPeaks double maxcondition double maxcondition1 double b double c double[] fitvalues double[] xopt double fopt double[][] xLocal double[][] arrScales double[][] rotation List<Integer> rperm double[] arrCondition", 0, 0, 2, 1, 1, 0, 1, 1
7467, 8123, 0, "Ambiguous return value: Selected block modifies more than one local variable used in subsequent code. Affected variables are:  double[] b double[][] M double[][] rot1 BBOBFunction problem", 0, 0, 9, 6, 3, 3, 3, 1
7424, 8438, 1, "OK", 4, 28, 9, 6, 3, 3, 3, 1
4358, 5180, 1, "OK", 6, 23, 9, 6, 3, 3, 3, 1
7304, 8066, 0, "Ambiguous return value: Selected block modifies more than one local variable used in subsequent code. Affected variables are:  double[] xopt double fopt double[] zeros double[] b double[][] M double[][] rot1 BBOBFunction problem", 0, 0, 9, 6, 3, 3, 3, 1
9561, 10805, 1, "OK", 4, 39, 16, 10, 6, 4, 6, 1
5965, 6565, 0, "Ambiguous return value: Selected block modifies more than one local variable used in subsequent code. Affected variables are:  double[] b double[][] M BBOBFunction problem", 0, 0, 9, 6, 3, 3, 3, 1
7702, 8013, 1, "OK", 5, 12, 9, 6, 3, 3, 3, 1
4434, 4878, 1, "OK", 6, 16, 9, 6, 3, 3, 3, 1
5274, 5468, 0, "Ambiguous return value: Selected block modifies more than one local variable used in subsequent code. Affected variables are:  double fopt double[] minusOne", 0, 0, 2, 1, 1, 0, 1, 1
11576, 11835, 1, "OK", 4, 9, 2, 1, 1, 0, 1, 1
10977, 12999, 0, "Ambiguous return value: Selected block modifies more than one local variable used in subsequent code. Affected variables are:  double fopt double[][] xLocal double[][] arrScales double[][] rotation double[] peaks", 0, 0, 25, 16, 9, 7, 9, 1
11451, 12634, 0, "Ambiguous return value: Selected block modifies more than one local variable used in subsequent code. Affected variables are:  double[] gallagher_peaks double[] peaks", 0, 0, 12, 7, 5, 2, 5, 1
7559, 8362, 1, "OK", 6, 22, 9, 6, 3, 3, 3, 1
9996, 10638, 1, "OK", 7, 21, 11, 7, 4, 3, 4, 1
11022, 12634, 0, "Ambiguous return value: Selected block modifies more than one local variable used in subsequent code. Affected variables are:  double b double c double[] xopt double fopt double[][] xLocal double[][] arrScales double[][] rotation double[] gallagher_peaks double[] peaks", 0, 0, 12, 7, 5, 2, 5, 1
11803, 12999, 1, "OK", 14, 42, 23, 15, 8, 7, 8, 1
9857, 10862, 1, "OK", 8, 33, 16, 10, 6, 4, 6, 1
10944, 12999, 0, "Ambiguous return value: Selected block modifies more than one local variable used in subsequent code. Affected variables are:  double fopt double[][] xLocal double[][] arrScales double[][] rotation double[] peaks", 0, 0, 25, 16, 9, 7, 9, 1
9765, 10638, 1, "OK", 5, 32, 16, 10, 6, 4, 6, 1
7635, 8066, 1, "OK", 5, 16, 9, 6, 3, 3, 3, 1
11749, 12634, 0, "Ambiguous return value: Selected block modifies more than one local variable used in subsequent code. Affected variables are:  double[] gallagher_peaks double[] peaks", 0, 0, 10, 6, 4, 2, 4, 1
4266, 4989, 0, "Ambiguous return value: Selected block modifies more than one local variable used in subsequent code. Affected variables are:  double[] b double[][] M BBOBFunction problem", 0, 0, 9, 6, 3, 3, 3, 1
9621, 9991, 0, "Ambiguous return value: Selected block modifies more than one local variable used in subsequent code. Affected variables are:  double fopt double[] xopt double[] tmp2 double[] b double[][] M", 0, 0, 5, 3, 2, 1, 2, 1
4501, 4878, 1, "OK", 6, 14, 9, 6, 3, 3, 3, 1
6133, 6511, 1, "OK", 5, 14, 9, 6, 3, 3, 3, 1
5334, 5677, 1, "OK", 2, 10, 2, 1, 1, 0, 1, 1
8593, 9096, 0, "Ambiguous return value: Selected block modifies more than one local variable used in subsequent code. Affected variables are:  double[] zeros double[] b double[][] M double[][] rot1", 0, 0, 5, 3, 2, 1, 2, 1
9804, 10467, 0, "Ambiguous return value: Selected block modifies more than one local variable used in subsequent code. Affected variables are:  double[][] M BBOBFunction problem", 0, 0, 16, 10, 6, 4, 6, 1
4206, 4812, 0, "Ambiguous return value: Selected block modifies more than one local variable used in subsequent code. Affected variables are:  double fopt double[] b double[][] M", 0, 0, 9, 6, 3, 3, 3, 1
10916, 11835, 0, "Ambiguous return value: Selected block modifies more than one local variable used in subsequent code. Affected variables are:  int numberOfPeaks double maxcondition double b double c double[] fitvalues double[] xopt double fopt double[][] xLocal double[][] arrScales double[][] rotation List<Integer> rperm double[] arrCondition", 0, 0, 2, 1, 1, 0, 1, 1
4305, 4812, 1, "OK", 3, 17, 9, 6, 3, 3, 3, 1
12186, 12413, 1, "OK", 4, 8, 3, 1, 1, 0, 1, 2
4603, 4801, 1, "OK", 6, 6, 4, 1, 1, 0, 1, 3
7364, 8297, 0, "Ambiguous return value: Selected block modifies more than one local variable used in subsequent code. Affected variables are:  double[] zeros double[][] rot1 BBOBFunction problem", 0, 0, 9, 6, 3, 3, 3, 1
9857, 10881, 1, "OK", 8, 34, 16, 10, 6, 4, 6, 1
11451, 11642, 0, "Ambiguous return value: Selected block modifies more than one local variable used in subsequent code. Affected variables are:  double[] gallagher_peaks List<Integer> rperm", 0, 0, 2, 1, 1, 0, 1, 1
7467, 8181, 0, "Ambiguous return value: Selected block modifies more than one local variable used in subsequent code. Affected variables are:  double[][] rot1 BBOBFunction problem", 0, 0, 9, 6, 3, 3, 3, 1
11022, 11642, 0, "Ambiguous return value: Selected block modifies more than one local variable used in subsequent code. Affected variables are:  double b double c double[] fitvalues double[] xopt double fopt double[][] xLocal double[][] arrScales double[][] rotation double[] gallagher_peaks List<Integer> rperm", 0, 0, 2, 1, 1, 0, 1, 1
7702, 8066, 1, "OK", 5, 14, 9, 6, 3, 3, 3, 1
5965, 6622, 0, "Ambiguous return value: Selected block modifies more than one local variable used in subsequent code. Affected variables are:  double[] b double[][] M BBOBFunction problem", 0, 0, 9, 6, 3, 3, 3, 1
11576, 11883, 0, "Ambiguous return value: Selected block modifies more than one local variable used in subsequent code. Affected variables are:  double[] arrCondition double[] peaks", 0, 0, 2, 1, 1, 0, 1, 1
9561, 10862, 1, "OK", 4, 40, 16, 10, 6, 4, 6, 1
4434, 4933, 1, "OK", 6, 17, 9, 6, 3, 3, 3, 1
7304, 8123, 0, "Ambiguous return value: Selected block modifies more than one local variable used in subsequent code. Affected variables are:  double[] xopt double[] zeros double[] b double[][] M double[][] rot1 BBOBFunction problem", 0, 0, 9, 6, 3, 3, 3, 1
9996, 10695, 1, "OK", 7, 22, 11, 7, 4, 3, 4, 1
11141, 13088, 0, "Ambiguous return value: Selected block modifies more than one local variable used in subsequent code. Affected variables are:  double fopt BBOBFunction problem", 0, 0, 25, 16, 9, 7, 9, 1
11042, 13088, 0, "Ambiguous return value: Selected block modifies more than one local variable used in subsequent code. Affected variables are:  double fopt BBOBFunction problem", 0, 0, 25, 16, 9, 7, 9, 1
5274, 5522, 0, "Ambiguous return value: Selected block modifies more than one local variable used in subsequent code. Affected variables are:  double fopt double[] minusOne BBOBFunction problem", 0, 0, 2, 1, 1, 0, 1, 1
6200, 6511, 1, "OK", 5, 12, 9, 6, 3, 3, 3, 1
5190, 13249, 1, "OK", 4, 228, 74, 74, 32, 42, 24, 0
7559, 8419, 1, "OK", 7, 23, 9, 6, 3, 3, 3, 1
7506, 8013, 0, "Ambiguous return value: Selected block modifies more than one local variable used in subsequent code. Affected variables are:  double[][] M double[][] rot1", 0, 0, 9, 6, 3, 3, 3, 1