A, B, feasible, reason, parameters, extractedLOC, reductionCC, extractedMethodCC, accumulatedInherentComponent, accumulatedNestingComponent, numberNestingContributors, nesting
2860, 4203, 0, "Selected statements contain a return statement but not all possible execution flows end in a return. Semantics may not be preserved if you proceed.", 0, 0, 14, 14, 10, 4, 4, 0
4412, 4606, 1, "OK", 2, 8, 3, 3, 2, 1, 1, 0
2740, 4088, 0, "Selected statements contain a return statement but not all possible execution flows end in a return. Semantics may not be preserved if you proceed.", 0, 0, 12, 12, 8, 4, 4, 0
2740, 4606, 1, "OK", 3, 69, 18, 18, 13, 5, 5, 0
3809, 3979, 0, "Selected statements contain a return statement but not all possible execution flows end in a return. Semantics may not be preserved if you proceed.", 0, 0, 2, 1, 1, 0, 1, 1
2860, 4088, 0, "Selected statements contain a return statement but not all possible execution flows end in a return. Semantics may not be preserved if you proceed.", 0, 0, 12, 12, 8, 4, 4, 0
2860, 4606, 1, "OK", 3, 65, 18, 18, 13, 5, 5, 0
2760, 4384, 0, "Selected statements contain a return statement but not all possible execution flows end in a return. Semantics may not be preserved if you proceed.", 0, 0, 15, 15, 11, 4, 4, 0
3901, 4084, 0, "Selected statements contain a return statement but not all possible execution flows end in a return. Semantics may not be preserved if you proceed.", 0, 0, 2, 1, 1, 0, 1, 1
4278, 4443, 0, "Selected statements contain a return statement but not all possible execution flows end in a return. Semantics may not be preserved if you proceed.", 0, 0, 1, 1, 1, 0, 0, 0
3448, 4443, 0, "Selected statements contain a return statement but not all possible execution flows end in a return. Semantics may not be preserved if you proceed.", 0, 0, 9, 9, 7, 2, 2, 0
2740, 4384, 0, "Selected statements contain a return statement but not all possible execution flows end in a return. Semantics may not be preserved if you proceed.", 0, 0, 15, 15, 11, 4, 4, 0
4142, 4443, 0, "Selected statements contain a return statement but not all possible execution flows end in a return. Semantics may not be preserved if you proceed.", 0, 0, 3, 3, 3, 0, 0, 0
2997, 3075, 0, "Selected statements contain a return statement but not all possible execution flows end in a return. Semantics may not be preserved if you proceed.", 0, 0, 2, 1, 1, 0, 1, 1
3229, 3307, 0, "Selected statements contain a return statement but not all possible execution flows end in a return. Semantics may not be preserved if you proceed.", 0, 0, 2, 1, 1, 0, 1, 1
3901, 3979, 0, "Selected statements contain a return statement but not all possible execution flows end in a return. Semantics may not be preserved if you proceed.", 0, 0, 2, 1, 1, 0, 1, 1
2760, 3384, 0, "Selected statements contain a return statement but not all possible execution flows end in a return. Semantics may not be preserved if you proceed.", 0, 0, 6, 6, 4, 2, 2, 0
2931, 3075, 0, "Selected statements contain a return statement but not all possible execution flows end in a return. Semantics may not be preserved if you proceed.", 0, 0, 2, 1, 1, 0, 1, 1
3163, 3307, 0, "Selected statements contain a return statement but not all possible execution flows end in a return. Semantics may not be preserved if you proceed.", 0, 0, 2, 1, 1, 0, 1, 1
2860, 4384, 0, "Selected statements contain a return statement but not all possible execution flows end in a return. Semantics may not be preserved if you proceed.", 0, 0, 15, 15, 11, 4, 4, 0
3448, 4203, 0, "Selected statements contain a return statement but not all possible execution flows end in a return. Semantics may not be preserved if you proceed.", 0, 0, 8, 8, 6, 2, 2, 0
3519, 3794, 0, "Selected statements contain a return statement but not all possible execution flows end in a return. Semantics may not be preserved if you proceed.", 0, 0, 2, 1, 1, 0, 1, 1
4142, 4203, 0, "Selected statements contain a return statement but not all possible execution flows end in a return. Semantics may not be preserved if you proceed.", 0, 0, 2, 2, 2, 0, 0, 0
3448, 4088, 0, "Selected statements contain a return statement but not all possible execution flows end in a return. Semantics may not be preserved if you proceed.", 0, 0, 6, 6, 4, 2, 2, 0
2740, 3384, 0, "Selected statements contain a return statement but not all possible execution flows end in a return. Semantics may not be preserved if you proceed.", 0, 0, 6, 6, 4, 2, 2, 0
3448, 4606, 1, "OK", 3, 44, 12, 12, 9, 3, 3, 0
3519, 3689, 0, "Selected statements contain a return statement but not all possible execution flows end in a return. Semantics may not be preserved if you proceed.", 0, 0, 2, 1, 1, 0, 1, 1
4278, 4606, 1, "OK", 3, 14, 4, 4, 3, 1, 1, 0
2860, 3384, 0, "Selected statements contain a return statement but not all possible execution flows end in a return. Semantics may not be preserved if you proceed.", 0, 0, 6, 6, 4, 2, 2, 0
4142, 4606, 1, "OK", 3, 19, 6, 6, 5, 1, 1, 0
2760, 4443, 0, "Selected statements contain a return statement but not all possible execution flows end in a return. Semantics may not be preserved if you proceed.", 0, 0, 15, 15, 11, 4, 4, 0
3611, 3794, 0, "Selected statements contain a return statement but not all possible execution flows end in a return. Semantics may not be preserved if you proceed.", 0, 0, 2, 1, 1, 0, 1, 1
4510, 4602, 0, "Section contains break statement but not the parent statement it belongs to.", 0, 0, 2, 1, 1, 0, 1, 1
2760, 4203, 0, "Selected statements contain a return statement but not all possible execution flows end in a return. Semantics may not be preserved if you proceed.", 0, 0, 14, 14, 10, 4, 4, 0
3448, 4384, 0, "Selected statements contain a return statement but not all possible execution flows end in a return. Semantics may not be preserved if you proceed.", 0, 0, 9, 9, 7, 2, 2, 0
2740, 4443, 0, "Selected statements contain a return statement but not all possible execution flows end in a return. Semantics may not be preserved if you proceed.", 0, 0, 15, 15, 11, 4, 4, 0
4278, 4384, 0, "Selected statements contain a return statement but not all possible execution flows end in a return. Semantics may not be preserved if you proceed.", 0, 0, 1, 1, 1, 0, 0, 0
3611, 3689, 0, "Selected statements contain a return statement but not all possible execution flows end in a return. Semantics may not be preserved if you proceed.", 0, 0, 2, 1, 1, 0, 1, 1
2760, 4088, 0, "Selected statements contain a return statement but not all possible execution flows end in a return. Semantics may not be preserved if you proceed.", 0, 0, 12, 12, 8, 4, 4, 0
2860, 4443, 0, "Selected statements contain a return statement but not all possible execution flows end in a return. Semantics may not be preserved if you proceed.", 0, 0, 15, 15, 11, 4, 4, 0
4142, 4384, 0, "Selected statements contain a return statement but not all possible execution flows end in a return. Semantics may not be preserved if you proceed.", 0, 0, 3, 3, 3, 0, 0, 0
3809, 4084, 0, "Selected statements contain a return statement but not all possible execution flows end in a return. Semantics may not be preserved if you proceed.", 0, 0, 2, 1, 1, 0, 1, 1
2760, 4606, 1, "OK", 3, 68, 18, 18, 13, 5, 5, 0
2740, 4203, 0, "Selected statements contain a return statement but not all possible execution flows end in a return. Semantics may not be preserved if you proceed.", 0, 0, 14, 14, 10, 4, 4, 0
2997, 3148, 0, "Selected statements contain a return statement but not all possible execution flows end in a return. Semantics may not be preserved if you proceed.", 0, 0, 2, 1, 1, 0, 1, 1
3229, 3380, 0, "Selected statements contain a return statement but not all possible execution flows end in a return. Semantics may not be preserved if you proceed.", 0, 0, 2, 1, 1, 0, 1, 1
2931, 3148, 0, "Selected statements contain a return statement but not all possible execution flows end in a return. Semantics may not be preserved if you proceed.", 0, 0, 2, 1, 1, 0, 1, 1
3163, 3380, 0, "Selected statements contain a return statement but not all possible execution flows end in a return. Semantics may not be preserved if you proceed.", 0, 0, 2, 1, 1, 0, 1, 1
4449, 4606, 1, "OK", 3, 6, 3, 3, 2, 1, 1, 0